4525167083,0,16,0,1,9,5,6,1,1,0,0,17366,6.8,17609,213,51,629,-887,21.3,1736.6,33,3,0,5,9,4,0,0,0,0,16737,7,18496,223,60,-629,887,22.3,1673.7
4525999060,0,46,2,0,3,6,0,1,0,1,0,14984,7,18050,235,64,-1287,-746,23.5,1498.4,19,3,1,6,3,3,1,1,0,0,16271,7,18796,237,58,1287,746,23.7,1627.1
4512479841,1,19,6,0,11,5,15,0,0,0,0,18945,7,18908,241,35,3107,2132,24.1,1894.5,66,3,1,5,11,9,0,0,0,0,15838,6.8,16776,199,52,-3107,-2132,19.9,1583.8
4516031571,0,15,5,0,8,5,6,0,0,0,0,17851,7.4,19947,257,44,1051,1224,25.7,1785.1,17,4,1,5,8,4,1,1,0,0,16800,7.2,18723,247,68,-1051,-1224,24.7,1680
4525797575,0,16,1,0,7,10,8,0,0,0,0,16900,6.8,16827,161,47,-1920,-3055,16.1,1690,17,5,1,10,7,8,1,1,0,0,18820,7.2,19882,225,70,1920,3055,22.5,1882
4505466847,0,42,3,0,3,4,4,0,0,0,0,14923,7,17661,229,48,-1899,-2290,22.9,1492.3,51,2,1,4,3,4,0,0,0,0,16822,7.2,19951,244,64,1899,2290,24.4,1682.2
4514465799,0,14,4,1,5,11,3,0,0,0,0,14790,6.6,16593,185,42,-3951,-2608,18.5,1479,32,2,0,11,5,15,1,1,0,0,18741,7.2,19201,225,51,3951,2608,22.5,1874.1
4526366514,1,16,2,1,7,6,7,0,0,0,0,18035,7,18668,250,48,1977,1635,25,1803.5,13,2,0,6,7,13,0,0,0,0,16058,6.8,17033,183,47,-1977,-1635,18.3,1605.8
4527530188,1,99,7,1,6,7,7,1,1,0,0,17193,7.4,18554,257,55,577,1371,25.7,1719.3,22,3,0,7,6,8,0,0,0,0,16616,6.8,17183,228,47,-577,-1371,22.8,1661.6
4527408690,1,15,4,1,13,3,11,0,0,0,0,19536,7.6,20584,217,58,5452,4510,21.7,1953.6,17,2,0,3,13,3,0,0,0,0,14084,6.4,16074,178,44,-5452,-4510,17.8,1408.4
4508769864,0,50,4,0,5,2,7,2,1,1,0,16444,7.4,18995,229,63,1415,1951,22.9,1644.4,16,3,1,2,5,3,0,0,0,0,15029,6.8,17044,225,53,-1415,-1951,22.5,1502.9
4526802762,0,20,2,0,1,11,2,0,0,0,0,13177,6.2,15610,177,48,-7314,-6034,17.7,1317.7,21,6,1,11,1,13,1,1,0,0,20491,7.8,21644,258,68,7314,6034,25.8,2049.1
4527439661,1,20,0,1,13,8,20,1,1,0,0,17564,6.6,15596,167,28,2032,1193,16.7,1756.4,18,2,0,8,13,10,0,0,0,0,15532,6,14403,170,34,-2032,-1193,17,1553.2
4526405624,0,16,0,1,10,8,12,1,1,0,0,17281,7,17509,203,39,-1125,-1326,20.3,1728.1,13,1,0,8,10,6,1,0,1,1,18406,7,18835,229,40,1125,1326,22.9,1840.6
4519461793,0,18,1,0,4,7,7,0,0,0,0,15818,6.8,17864,233,47,-60,1347,23.3,1581.8,62,3,1,7,4,13,1,1,0,0,15878,6.6,16517,186,36,60,-1347,18.6,1587.8
4525339465,0,17,2,0,5,7,8,0,0,0,0,16208,7,18110,218,54,-1656,-1363,21.8,1620.8,12,3,1,7,5,7,1,1,0,0,17864,7.2,19473,242,73,1656,1363,24.2,1786.4
4515440018,0,136,7,1,6,5,3,1,0,1,1,17174,7,18458,231,49,507,510,23.1,1717.4,38,2,0,5,6,5,1,1,0,0,16667,7,17948,233,57,-507,-510,23.3,1666.7
4521530556,1,17,1,0,10,5,11,1,1,0,0,17920,7,18730,224,51,2536,746,22.4,1792,37,4,1,5,10,5,0,0,0,0,15384,7,17984,220,48,-2536,-746,22,1538.4
4517920600,1,16,4,0,6,7,5,1,1,0,0,15882,7.2,18675,198,68,-1019,-361,19.8,1588.2,15,3,1,7,6,5,0,0,0,0,16901,7,19036,240,56,1019,361,24,1690.1
4527391946,0,14,1,0,6,11,6,0,0,0,0,15801,6.6,17010,209,49,-1603,-809,20.9,1580.1,14,3,1,11,6,12,2,1,1,0,17404,7,17819,204,34,1603,809,20.4,1740.4
4516105924,0,39,5,1,10,5,13,0,0,0,0,18866,7.4,19651,252,51,3412,2086,25.2,1886.6,18,3,0,5,10,8,0,0,0,0,15454,7,17565,207,49,-3412,-2086,20.7,1545.4
4518005964,0,19,6,1,1,4,1,2,1,1,0,14056,6.6,16260,223,50,-1903,-2537,22.3,1405.6,22,5,0,4,1,3,0,0,0,0,15959,7,18797,231,55,1903,2537,23.1,1595.9
4521217468,0,42,8,0,5,10,4,1,1,0,0,15876,6.8,17206,224,39,-2266,-2047,22.4,1587.6,20,5,1,10,5,9,1,0,1,0,18142,7.2,19253,221,60,2266,2047,22.1,1814.2
4526264359,0,15,0,1,3,3,2,1,0,1,0,15567,7,18798,232,52,62,1348,23.2,1556.7,12,0,0,3,3,5,0,0,0,0,15505,7,17450,237,56,-62,-1348,23.7,1550.5
4515338624,0,13,1,0,5,11,8,0,0,0,0,15979,6.8,16648,190,39,-3456,-1429,19,1597.9,15,1,1,11,5,15,2,1,1,0,19435,7,18077,189,44,3456,1429,18.9,1943.5
4524245111,0,16,2,0,6,5,4,1,1,0,0,16398,6.6,17974,236,53,768,505,23.6,1639.8,56,5,1,5,6,5,0,0,0,0,15630,7,17469,218,49,-768,-505,21.8,1563
4464331919,0,48,2,1,4,4,3,1,0,1,0,15721,7.2,18756,213,64,-1050,89,21.3,1572.1,18,0,0,4,4,6,1,1,0,0,16771,7.2,18667,238,56,1050,-89,23.8,1677.1
4520317076,0,15,4,0,2,8,1,0,0,0,0,14206,6.6,16793,200,50,-3427,-1792,20,1420.6,19,1,1,8,2,7,1,1,0,0,17633,7,18585,253,48,3427,1792,25.3,1763.3
4517907839,1,12,3,1,15,5,18,1,1,0,1,20844,7.2,18777,250,39,6672,3761,25,2084.4,22,1,0,5,15,4,1,0,1,0,14172,6,15016,171,44,-6672,-3761,17.1,1417.2
4521327659,1,13,2,1,8,3,9,1,1,0,0,17428,7.2,19729,220,50,2087,2578,22,1742.8,17,4,0,3,8,2,0,0,0,0,15341,6.8,17151,229,65,-2087,-2578,22.9,1534.1
4527366707,1,18,2,0,7,2,10,0,0,0,0,16879,7.2,18526,211,52,2053,1126,21.1,1687.9,15,3,1,2,7,3,1,1,0,0,14826,6.8,17400,232,64,-2053,-1126,23.2,1482.6
4526361954,1,24,0,1,8,2,9,1,1,0,1,17422,6.8,17192,211,24,2394,-1292,21.1,1742.2,36,5,0,2,8,3,0,0,0,0,15028,7,18484,210,76,-2394,1292,21,1502.8
4500489540,0,14,1,0,3,3,3,0,0,0,0,15255,7,18312,228,45,-112,233,22.8,1525.5,39,1,1,3,3,3,0,0,0,0,15367,7,18079,234,56,112,-233,23.4,1536.7
4513422670,0,35,3,0,6,9,8,1,1,0,0,16978,7.2,19145,205,55,-1712,-394,20.5,1697.8,20,2,1,9,6,16,0,0,0,0,18690,7.4,19539,208,56,1712,394,20.8,1869
4526746921,0,14,3,0,6,9,9,1,1,0,0,15738,6.6,16512,188,53,-2550,-1985,18.8,1573.8,15,1,1,9,6,6,0,0,0,0,18288,7,18497,224,57,2550,1985,22.4,1828.8
4526966381,0,14,2,0,9,6,8,0,0,0,0,17079,7,18150,203,47,899,295,20.3,1707.9,101,4,1,6,9,7,1,1,0,0,16180,7,17855,225,36,-899,-295,22.5,1618
4526838026,1,16,2,1,1,4,1,0,0,0,0,14761,7,17655,230,56,-294,-1277,23,1476.1,53,1,0,4,1,4,0,0,0,0,15055,7.2,18932,193,52,294,1277,19.3,1505.5
4520747802,1,17,3,1,12,4,10,1,1,0,0,19724,7.8,20621,263,49,4999,3308,26.3,1972.4,19,4,0,4,12,4,1,0,1,0,14725,6.6,17313,148,73,-4999,-3308,14.8,1472.5
4526781753,0,16,4,1,8,3,12,1,1,0,0,17479,7.2,19021,243,48,2143,1315,24.3,1747.9,17,5,0,3,8,4,0,0,0,0,15336,7,17706,203,44,-2143,-1315,20.3,1533.6
4523917327,1,15,2,0,16,10,17,2,1,1,0,20344,7,18646,193,48,3175,1975,19.3,2034.4,43,1,1,10,16,11,0,0,0,0,17169,6.6,16671,162,32,-3175,-1975,16.2,1716.9
4497655000,0,17,3,0,2,6,2,0,0,0,0,15141,7.2,18537,230,62,-2506,-1979,23,1514.1,41,4,1,6,2,9,1,1,0,0,17647,7.6,20516,250,70,2506,1979,25,1764.7
4526194900,0,17,2,0,4,3,5,0,0,0,0,15793,6.8,17950,246,40,848,463,24.6,1579.3,49,2,1,3,4,3,1,1,0,0,14945,7,17487,210,52,-848,-463,21,1494.5
4512044253,1,16,5,1,6,9,4,0,0,0,0,15653,6.6,16241,203,40,-2026,-1235,20.3,1565.3,20,5,0,9,6,14,1,1,0,0,17679,7,17476,216,51,2026,1235,21.6,1767.9
4519376202,1,14,2,1,5,3,4,1,1,0,0,15836,7,18174,223,44,813,487,22.3,1583.6,14,1,0,3,5,3,0,0,0,0,15023,6.8,17687,219,64,-813,-487,21.9,1502.3
4503713069,1,17,0,1,4,2,4,0,0,0,0,14673,6.4,16034,183,47,-110,-1469,18.3,1467.3,14,3,0,2,4,3,2,1,1,0,14783,6.8,17503,214,56,110,1469,21.4,1478.3
4527158569,1,18,5,1,10,4,11,0,0,0,0,18270,7,18656,249,41,3134,1069,24.9,1827,41,3,0,4,10,1,1,1,0,0,15136,7,17587,217,52,-3134,-1069,21.7,1513.6
4527454154,0,19,5,1,13,12,19,0,0,0,0,19362,6.6,17316,195,28,965,1856,19.5,1936.2,16,2,0,12,13,20,1,0,1,0,18397,6.4,15460,180,40,-965,-1856,18,1839.7
4525563784,0,14,4,1,5,6,6,1,1,0,0,15820,6.8,17954,200,59,40,1340,20,1582,31,3,0,6,5,8,0,0,0,0,15780,6.6,16614,212,48,-40,-1340,21.2,1578
4492374255,1,18,2,1,5,3,5,1,1,0,0,16583,6.8,17825,219,60,961,-900,21.9,1658.3,13,1,0,3,5,2,1,0,1,0,15622,7,18725,234,64,-961,900,23.4,1562.2
4509228650,1,16,1,1,9,3,6,1,1,0,0,18558,7.2,19625,269,51,3958,3881,26.9,1855.8,12,1,0,3,9,4,1,0,1,0,14600,6.4,15744,194,43,-3958,-3881,19.4,1460
4499967324,1,17,3,1,6,4,7,0,0,0,0,17477,7,19006,232,64,1814,73,23.2,1747.7,14,0,0,4,6,4,1,1,0,0,15663,7,18933,210,72,-1814,-73,21,1566.3
4498918077,1,14,2,1,3,7,2,0,0,0,0,14935,7,18365,198,59,-3469,-1687,19.8,1493.5,13,3,0,7,3,9,2,1,1,0,18404,7.2,20052,263,72,3469,1687,26.3,1840.4
4526188851,1,18,2,1,14,6,10,1,0,1,0,19203,7.4,20047,220,49,3548,3559,22,1920.3,16,1,0,6,14,7,1,1,0,0,15655,6.6,16488,204,30,-3548,-3559,20.4,1565.5
4521641532,1,12,4,1,6,6,3,0,0,0,0,16701,6.8,17820,237,40,882,450,23.7,1670.1,18,2,0,6,6,5,0,0,0,0,15819,6.8,17370,192,56,-882,-450,19.2,1581.9
4502676809,0,68,2,1,13,3,19,1,0,1,0,17529,6.8,17038,138,40,1530,-1195,13.8,1752.9,17,5,0,3,13,2,1,1,0,0,15999,6.8,18233,243,63,-1530,1195,24.3,1599.9
4517665139,0,19,4,0,4,8,5,0,0,0,0,15264,6.4,16327,208,44,-3212,-1661,20.8,1526.4,19,5,1,8,4,10,0,0,0,0,18476,7,17988,217,42,3212,1661,21.7,1847.6
4526573339,0,55,2,1,8,6,7,1,1,0,0,17403,7.4,19112,215,47,1518,1874,21.5,1740.3,17,1,0,6,8,9,0,0,0,0,15885,6.6,17238,192,40,-1518,-1874,19.2,1588.5
4526195389,1,18,3,1,4,6,2,1,0,1,0,15500,6.8,17374,218,56,-1006,-1606,21.8,1550,45,3,0,6,4,5,1,1,0,0,16506,7.2,18980,221,48,1006,1606,22.1,1650.6
4510184598,0,26,2,0,2,5,5,0,0,0,0,12886,6,14091,165,32,-3117,-3799,16.5,1288.6,13,4,1,5,2,4,1,1,0,0,16003,6.8,17890,206,60,3117,3799,20.6,1600.3
4527284987,1,17,2,1,6,3,7,1,1,0,1,17780,7.2,18440,221,48,3170,2080,22.1,1778,12,2,0,3,6,4,0,0,0,0,14610,6.4,16360,213,41,-3170,-2080,21.3,1461
4509444763,1,17,1,0,3,7,2,0,0,0,0,15632,7,18400,232,72,-1822,-1467,23.2,1563.2,16,4,1,7,3,6,2,1,1,0,17454,7.4,19867,244,52,1822,1467,24.4,1745.4
4525200443,1,17,2,1,6,7,5,1,1,0,0,16230,6.8,17203,190,59,-726,-1249,19,1623,16,1,0,7,6,12,0,0,0,0,16956,7.2,18452,230,53,726,1249,23,1695.6
4506796397,1,14,1,0,4,2,4,1,1,0,0,15346,7,18388,232,52,1342,1886,23.2,1534.6,14,0,1,2,4,2,0,0,0,0,14004,6.6,16502,206,40,-1342,-1886,20.6,1400.4
4515299761,0,21,3,1,3,2,4,1,1,0,0,15718,7,17991,250,53,1464,925,25,1571.8,92,5,0,2,3,4,0,0,0,0,14254,6.6,17066,215,52,-1464,-925,21.5,1425.4
4511146118,1,76,3,1,6,4,9,1,1,0,0,17620,7,19434,233,64,2387,1411,23.3,1762,18,1,0,4,6,7,0,0,0,0,15233,6.8,18023,201,67,-2387,-1411,20.1,1523.3
4515302737,0,16,2,0,4,13,4,0,0,0,0,14958,6.8,16993,207,47,-4629,-3393,20.7,1495.8,55,4,1,13,4,16,1,1,0,0,19587,7.4,20386,239,46,4629,3393,23.9,1958.7
4495228612,0,17,1,0,2,6,2,0,0,0,0,14025,6.6,16510,205,51,-2846,-1964,20.5,1402.5,22,2,1,6,2,4,1,1,0,0,16871,6.8,18474,218,64,2846,1964,21.8,1687.1
4496483368,1,48,3,1,4,3,3,2,1,1,0,15656,7,17844,227,48,85,-706,22.7,1565.6,18,3,0,3,4,3,0,0,0,0,15571,7,18550,217,63,-85,706,21.7,1557.1
4515415640,0,20,1,1,9,14,10,0,0,0,0,17155,6.6,16245,183,32,-4473,-2976,18.3,1715.5,15,4,0,14,9,16,2,1,1,1,21628,7,19221,214,51,4473,2976,21.4,2162.8
4523576298,1,14,4,1,8,3,7,1,1,0,0,16595,7.2,18940,210,55,859,2681,21,1659.5,21,1,0,3,8,7,0,0,0,0,15736,6.4,16259,203,39,-859,-2681,20.3,1573.6
4524577169,1,20,5,1,9,8,13,1,1,0,0,17283,6.6,16810,205,28,-428,5,20.5,1728.3,18,3,0,8,9,7,1,0,1,0,17711,6.6,16805,213,36,428,-5,21.3,1771.1
4518919101,0,11,3,0,5,8,9,0,0,0,0,15388,6.4,15598,179,39,-4104,-3458,17.9,1538.8,16,3,1,8,5,8,0,0,0,1,19492,7.2,19056,264,55,4104,3458,26.4,1949.2
4527605062,0,15,4,1,11,10,9,1,0,1,0,17797,7,17892,191,36,354,248,19.1,1779.7,18,2,0,10,11,11,0,0,0,0,17443,6.8,17644,198,44,-354,-248,19.8,1744.3
4511899232,1,22,6,0,6,7,6,0,0,0,0,17170,7,18110,243,60,959,2183,24.3,1717,17,6,1,7,6,10,0,0,0,0,16211,6.4,15927,194,36,-959,-2183,19.4,1621.1
4522413426,1,15,0,1,4,2,5,0,0,0,0,16729,7,18725,227,48,1970,804,22.7,1672.9,16,1,0,2,4,2,0,0,0,0,14759,6.8,17921,228,73,-1970,-804,22.8,1475.9
4515922365,0,11,1,1,8,9,6,0,0,0,0,17424,7.2,18146,224,37,-618,-669,22.4,1742.4,17,2,0,9,8,8,0,0,0,0,18042,7,18815,223,57,618,669,22.3,1804.2
4507608751,0,19,2,1,8,7,12,2,1,1,0,16912,6.8,17022,213,57,106,-1098,21.3,1691.2,26,4,0,7,8,6,0,0,0,0,16806,7,18120,179,60,-106,1098,17.9,1680.6
4524488615,0,64,4,1,12,6,18,1,0,1,1,19426,6.8,18749,218,37,4146,3141,21.8,1942.6,21,4,0,6,12,8,1,1,0,0,15280,6.4,15608,191,44,-4146,-3141,19.1,1528
4521968003,0,14,1,1,5,4,5,0,0,0,0,16062,6.8,17907,195,61,39,-1075,19.5,1606.2,48,3,0,4,5,3,1,1,0,0,16023,7.2,18982,237,61,-39,1075,23.7,1602.3
4508126209,1,10,4,0,7,4,4,1,0,1,1,17440,7,18208,197,55,2367,1946,19.7,1744,17,3,1,4,7,3,1,1,0,0,15073,6.6,16262,178,63,-2367,-1946,17.8,1507.3
4525991755,0,17,3,1,3,11,3,0,0,0,0,15273,6.6,16831,227,41,-2111,-1607,22.7,1527.3,22,2,0,11,3,11,1,1,0,0,17384,6.8,18438,218,48,2111,1607,21.8,1738.4
4510144910,1,16,6,0,5,6,5,0,0,0,0,16571,7.2,19112,212,66,-528,1756,21.2,1657.1,19,3,1,6,5,7,2,1,1,0,17099,6.6,17356,210,49,528,-1756,21,1709.9
4510116594,1,18,2,1,10,5,9,1,0,1,1,19204,7.2,20182,228,59,4424,4969,22.8,1920.4,12,1,0,5,10,8,1,1,0,0,14780,6.4,15213,187,36,-4424,-4969,18.7,1478
4525296321,0,15,0,1,2,4,2,0,0,0,0,15210,6.8,17457,222,45,262,-414,22.2,1521,15,1,0,4,2,5,2,1,1,0,14948,7,17871,216,46,-262,414,21.6,1494.8
4526741895,0,13,4,1,6,8,7,0,0,0,0,17190,6.8,17552,226,44,777,576,22.6,1719,17,1,0,8,6,9,0,0,0,0,16413,6.6,16976,190,30,-777,-576,19,1641.3
4510821185,0,19,5,0,6,6,4,0,0,0,0,16839,7,18230,222,57,468,370,22.2,1683.9,19,3,1,6,6,8,1,1,0,0,16371,6.8,17860,211,58,-468,-370,21.1,1637.1
4516090718,0,21,1,0,3,7,2,0,0,0,0,14552,6.6,16760,222,49,-3408,-1490,22.2,1455.2,17,4,1,7,3,5,2,1,1,1,17960,7,18250,228,44,3408,1490,22.8,1796
4525553823,1,14,0,0,10,4,13,1,1,0,0,19359,7.2,19182,243,53,4424,2663,24.3,1935.9,53,4,1,4,10,5,0,0,0,0,14935,6.8,16519,189,62,-4424,-2663,18.9,1493.5
4493623351,1,22,2,1,6,6,4,2,1,1,0,16043,7,18113,213,56,-76,1720,21.3,1604.3,14,1,0,6,6,8,0,0,0,0,16119,6.6,16393,206,40,76,-1720,20.6,1611.9
4506599710,0,13,1,0,5,16,4,0,0,0,0,15723,6.4,15978,196,64,-5601,-4942,19.6,1572.3,15,1,1,16,5,22,1,1,0,0,21324,7.6,20920,210,47,5601,4942,21,2132.4
4525005115,0,13,3,0,6,6,9,0,0,0,0,17924,7,18749,248,46,870,703,24.8,1792.4,17,1,1,6,6,9,0,0,0,0,17054,6.8,18046,241,39,-870,-703,24.1,1705.4
4516402388,1,15,4,1,4,3,2,1,0,1,0,15833,7.2,18396,250,52,904,1043,25,1583.3,21,4,0,3,4,3,1,1,0,0,14929,6.8,17353,213,64,-904,-1043,21.3,1492.9
4521730621,1,16,2,1,6,3,7,1,0,1,0,16691,7.4,19203,226,60,1814,1762,22.6,1669.1,12,2,0,3,6,3,0,0,0,0,14877,6.8,17441,214,55,-1814,-1762,21.4,1487.7
4526612665,0,21,3,1,1,1,3,0,0,0,0,15301,7,18098,249,72,166,-436,24.9,1530.1,17,4,0,1,1,0,1,1,0,0,15135,6.8,18534,230,60,-166,436,23,1513.5
4527526766,0,18,3,1,7,8,6,0,0,0,0,16132,7,17360,207,48,-1211,-2257,20.7,1613.2,35,2,0,8,7,9,1,0,1,0,17343,7.2,19617,244,52,1211,2257,24.4,1734.3
4515305761,0,14,1,1,7,6,7,0,0,0,0,17513,7.2,18336,228,51,1941,846,22.8,1751.3,121,3,0,6,7,5,1,0,1,0,15572,6.6,17490,188,48,-1941,-846,18.8,1557.2
4526921944,1,16,5,0,7,6,9,1,1,0,0,17108,7,18548,230,59,990,1798,23,1710.8,51,6,1,6,7,6,0,0,0,0,16118,6.6,16750,218,48,-990,-1798,21.8,1611.8
4510935065,1,23,3,0,6,5,8,2,1,1,0,17178,7,18411,234,74,2614,2285,23.4,1717.8,16,2,1,5,6,2,0,0,0,0,14564,6.4,16126,170,52,-2614,-2285,17,1456.4
4505405974,0,18,4,0,3,4,3,0,0,0,0,14511,6.6,16462,212,42,-342,-2245,21.2,1451.1,18,2,1,4,3,1,1,1,0,0,14853,7.4,18707,212,43,342,2245,21.2,1485.3
4523899189,0,16,0,0,1,11,1,1,0,1,0,13199,6.2,15949,173,49,-6134,-4660,17.3,1319.9,15,1,1,11,1,13,0,0,0,0,19333,7.6,20609,255,54,6134,4660,25.5,1933.3
4507851254,1,52,2,0,6,5,12,0,0,0,1,17107,6.8,17665,215,43,-1661,-1259,21.5,1710.7,19,3,1,5,6,4,2,1,1,2,18768,7,18924,239,71,1661,1259,23.9,1876.8
4526397117,0,54,4,0,6,16,3,0,0,0,0,14731,6.2,15155,154,44,-6086,-3112,15.4,1473.1,21,5,1,16,6,20,0,0,0,0,20817,7,18267,237,32,6086,3112,23.7,2081.7
4516262815,0,28,4,1,4,7,6,0,0,0,0,14937,6.8,16417,211,57,-2601,-3694,21.1,1493.7,15,5,0,7,4,8,2,1,1,0,17538,7.4,20111,232,60,2601,3694,23.2,1753.8
4508188294,0,13,1,0,1,10,1,0,0,0,0,13340,6.2,15466,223,32,-3586,-2271,22.3,1334,37,1,1,10,1,16,1,1,0,0,16926,6.8,17737,189,32,3586,2271,18.9,1692.6
4516175381,1,15,3,0,9,4,11,1,0,1,1,19684,7.4,20073,217,60,3920,3302,21.7,1968.4,19,1,1,4,9,3,1,1,0,0,15764,6.6,16771,219,48,-3920,-3302,21.9,1576.4
4504961741,0,14,3,0,2,7,2,0,0,0,0,15461,6.8,17683,206,60,-1912,-2257,20.6,1546.1,16,2,1,7,2,7,2,1,1,0,17373,7.2,19940,243,55,1912,2257,24.3,1737.3
4527013199,1,19,3,1,3,2,1,1,1,0,0,14700,6.8,17577,234,40,203,411,23.4,1470,15,1,0,2,3,0,0,0,0,0,14497,6.8,17166,253,40,-203,-411,25.3,1449.7
4523014807,0,80,0,0,5,7,5,1,1,0,0,17026,7,18231,213,76,17,-403,21.3,1702.6,15,2,1,7,5,6,1,0,1,0,17009,7,18634,218,68,-17,403,21.8,1700.9
4513262976,1,18,5,0,4,1,9,1,1,0,0,15357,6.8,17204,200,59,1273,1061,20,1535.7,16,5,1,1,4,2,0,0,0,0,14084,6.4,16143,239,40,-1273,-1061,23.9,1408.4
4511560979,1,19,2,1,9,7,9,0,0,0,0,17498,7,17932,200,42,1023,19,20,1749.8,16,2,0,7,9,6,1,0,1,0,16475,6.8,17913,196,32,-1023,-19,19.6,1647.5
4520677506,0,16,4,0,5,12,3,0,0,0,0,15140,6.4,15745,198,39,-3371,-2094,19.8,1514,19,4,1,12,5,15,1,1,0,0,18511,7,17839,217,52,3371,2094,21.7,1851.1
4502187260,1,17,0,0,5,5,7,1,1,0,0,16398,7,17450,218,52,455,524,21.8,1639.8,34,3,1,5,5,10,0,0,0,0,15943,6.6,16926,184,56,-455,-524,18.4,1594.3
4499958470,1,12,3,1,8,7,7,1,1,0,0,16972,7,18007,184,44,891,1054,18.4,1697.2,14,1,0,7,8,7,0,0,0,0,16081,6.6,16953,196,51,-891,-1054,19.6,1608.1
4515405283,1,17,1,1,9,2,5,0,0,0,0,17777,7.4,19414,238,48,3361,3545,23.8,1777.7,13,4,0,2,9,1,0,0,0,0,14416,6.4,15869,208,44,-3361,-3545,20.8,1441.6
4507361840,1,13,2,1,5,0,4,1,1,0,0,16184,7,18007,223,51,2813,1222,22.3,1618.4,10,1,0,0,5,0,0,0,0,0,13371,6.6,16785,210,48,-2813,-1222,21,1337.1
4524432145,0,16,3,0,2,9,2,0,0,0,0,14085,6.4,15408,220,38,-3803,-4020,22,1408.5,18,1,1,9,2,4,2,1,1,0,17888,7.2,19428,245,60,3803,4020,24.5,1788.8
4520393819,0,18,1,0,3,8,7,0,0,0,0,13944,6.6,15850,185,48,-3179,-2574,18.5,1394.4,20,8,1,8,3,7,1,1,0,0,17123,7,18424,230,48,3179,2574,23,1712.3
4526463551,1,12,3,0,5,5,9,1,0,1,0,16730,7,17875,246,52,913,14,24.6,1673,13,1,1,5,5,6,0,0,0,0,15817,6.8,17861,205,55,-913,-14,20.5,1581.7
4509912325,0,91,6,0,2,7,4,1,1,0,0,14507,6.4,16400,215,52,-2328,-1153,21.5,1450.7,39,4,1,7,2,7,1,0,1,0,16835,6.8,17553,189,52,2328,1153,18.9,1683.5
4500758872,0,11,0,0,4,8,6,0,0,0,0,14327,6.6,16104,194,30,-3392,-2116,19.4,1432.7,15,2,1,8,4,7,1,1,0,0,17719,6.8,18220,223,41,3392,2116,22.3,1771.9
4527276272,0,13,10,0,8,10,8,1,1,0,0,17048,7,18361,230,61,171,1158,23,1704.8,43,5,1,10,8,10,0,0,0,0,16877,6.8,17203,185,35,-171,-1158,18.5,1687.7
4495265791,0,17,2,1,4,2,4,0,0,0,0,16103,7,17909,238,60,1119,-12,23.8,1610.3,19,4,0,2,4,0,0,0,0,0,14984,6.8,17921,245,48,-1119,12,24.5,1498.4
4511710215,1,16,5,0,5,10,6,0,0,0,0,16413,6.8,18104,225,50,-3036,-2088,22.5,1641.3,16,3,1,10,5,8,1,1,0,0,19449,7.4,20192,251,69,3036,2088,25.1,1944.9
4519161047,1,14,3,1,9,5,6,1,0,1,0,18122,7.2,19174,233,57,2195,554,23.3,1812.2,15,0,0,5,9,4,0,0,0,0,15927,7.2,18620,200,54,-2195,-554,20,1592.7
4527552331,1,36,4,0,11,13,11,0,0,0,0,17166,6.8,17136,165,36,-1030,-319,16.5,1716.6,16,5,1,13,11,8,1,0,1,0,18196,6.6,17455,203,44,1030,319,20.3,1819.6
4527674741,0,17,5,1,3,3,5,1,0,1,0,15079,6.6,15930,212,44,607,-1168,21.2,1507.9,55,3,0,3,3,5,1,1,0,0,14472,6.8,17098,210,38,-607,1168,21,1447.2
4526242202,1,10,17,1,8,7,6,1,0,1,1,18766,6.8,17630,216,50,2343,-1514,21.6,1876.6,41,1,0,7,8,13,1,1,0,0,16423,7.2,19144,202,55,-2343,1514,20.2,1642.3
4510087493,0,40,4,1,1,8,3,0,0,0,0,13802,6.4,15735,212,40,-4177,-2986,21.2,1380.2,15,3,0,8,1,9,1,1,0,0,17979,7,18721,247,43,4177,2986,24.7,1797.9
4513447040,1,15,4,0,4,3,3,1,1,0,0,16044,7,18612,237,62,1223,2123,23.7,1604.4,19,5,1,3,4,3,1,0,1,0,14821,6.6,16489,231,47,-1223,-2123,23.1,1482.1
4521428251,0,13,1,0,2,14,3,0,0,0,0,14535,6.6,16907,195,67,-6147,-1215,19.5,1453.5,18,1,1,14,2,21,2,1,1,1,20682,7,18122,189,48,6147,1215,18.9,2068.2
4506659167,0,14,3,0,8,11,7,2,1,1,0,16936,6.6,16881,209,56,-865,-480,20.9,1693.6,16,2,1,11,8,12,0,0,0,0,17801,7,17361,188,43,865,480,18.8,1780.1
4518419610,0,93,4,1,5,7,4,0,0,0,0,16082,6.6,17246,220,38,-974,-1306,22,1608.2,16,5,0,7,5,9,0,0,0,0,17056,6.8,18552,228,52,974,1306,22.8,1705.6
4526228041,1,15,3,1,10,4,11,0,0,0,0,18346,7,18224,228,36,3454,1882,22.8,1834.6,16,3,0,4,10,5,2,1,1,0,14892,6.6,16342,192,52,-3454,-1882,19.2,1489.2
4526718235,1,10,5,0,16,13,16,2,1,1,0,19437,7,18500,188,32,546,680,18.8,1943.7,15,1,1,13,16,10,0,0,0,0,18891,7,17820,191,52,-546,-680,19.1,1889.1
4525334878,0,26,2,0,8,8,8,1,0,1,0,16145,7.2,19030,192,47,-1580,358,19.2,1614.5,16,4,1,8,8,7,1,1,0,0,17725,7.2,18672,224,62,1580,-358,22.4,1772.5
4525766056,1,23,2,1,6,3,7,1,1,0,0,16600,7.2,18185,238,53,1825,996,23.8,1660,17,3,0,3,6,4,0,0,0,0,14775,6.8,17189,228,39,-1825,-996,22.8,1477.5
4518530813,0,23,3,0,11,6,12,0,0,0,0,17944,7,17835,214,30,901,144,21.4,1794.4,21,7,1,6,11,5,0,0,0,0,17043,6.8,17691,230,53,-901,-144,23,1704.3
4498407529,1,11,2,0,5,7,3,0,0,0,0,14439,6.4,16062,171,35,-3435,-1632,17.1,1443.9,15,2,1,7,5,6,1,1,0,0,17874,6.8,17694,230,68,3435,1632,23,1787.4
4511237975,1,18,1,0,3,7,3,0,0,0,0,15008,6.8,17439,214,56,-3688,-2808,21.4,1500.8,15,2,1,7,3,9,1,1,0,0,18696,7.4,20247,258,64,3688,2808,25.8,1869.6
4522154425,0,37,6,1,2,7,4,0,0,0,0,15262,6.6,17524,232,50,-1033,-104,23.2,1526.2,55,7,0,7,2,10,1,1,0,0,16295,7,17628,211,59,1033,104,21.1,1629.5
4517945518,1,42,3,1,7,3,4,1,1,0,0,16305,7,18269,217,48,1947,1867,21.7,1630.5,13,14,0,3,7,2,0,0,0,0,14358,6.6,16402,180,56,-1947,-1867,18,1435.8
4519991691,0,61,0,1,3,13,4,0,0,0,0,13908,5.4,12798,167,38,-4561,-5031,16.7,1390.8,16,2,0,13,3,20,1,1,0,0,18469,7,17829,187,58,4561,5031,18.7,1846.9
4499304151,0,43,5,1,8,2,11,1,1,0,0,17554,7.2,19243,204,51,3255,1724,20.4,1755.4,17,1,0,2,8,1,0,0,0,0,14299,6.8,17519,211,46,-3255,-1724,21.1,1429.9
4464398381,0,18,1,0,7,10,8,0,0,0,0,15543,6.4,15357,193,44,-3333,-2568,19.3,1554.3,13,5,1,10,7,12,0,0,0,0,18876,7,17925,234,40,3333,2568,23.4,1887.6
4498032785,1,16,4,1,8,0,12,1,1,0,0,17519,7.2,19252,222,52,3272,1914,22.2,1751.9,15,2,0,0,8,0,0,0,0,0,14247,6.6,17338,232,52,-3272,-1914,23.2,1424.7
4519579618,1,12,2,1,11,7,11,2,1,1,0,17788,7,17625,178,50,1655,2014,17.8,1778.8,17,2,0,7,11,12,0,0,0,0,16133,6.4,15611,195,22,-1655,-2014,19.5,1613.3
4519214985,1,17,3,0,8,7,14,0,0,0,0,17261,6.8,17685,219,44,-112,-198,21.9,1726.1,12,2,1,7,8,8,1,1,0,0,17373,7,17883,221,52,112,198,22.1,1737.3
4515178661,0,18,4,1,5,4,5,1,0,1,0,16313,6.8,17999,234,45,-220,67,23.4,1631.3,35,4,0,4,5,5,1,1,0,0,16533,7.2,17932,232,48,220,-67,23.2,1653.3
4513554113,0,16,2,0,0,7,0,0,0,0,0,12774,6.6,15643,199,44,-4538,-2876,19.9,1277.4,23,3,1,7,0,13,1,1,0,0,17312,6.8,18519,250,57,4538,2876,25,1731.2
4526270984,0,26,2,0,4,9,3,0,0,0,0,16003,7.2,18376,229,61,-1515,-4,22.9,1600.3,13,4,1,9,4,11,2,1,1,0,17518,7.2,18380,219,56,1515,4,21.9,1751.8
4505401172,0,15,5,1,7,7,6,1,1,0,0,15472,6.8,17032,181,54,-1851,-1875,18.1,1547.2,18,4,0,7,7,4,0,0,0,0,17323,7.2,18907,211,56,1851,1875,21.1,1732.3
4515376975,1,11,3,0,4,6,5,1,0,1,0,16697,7,19148,233,69,601,-303,23.3,1669.7,42,5,1,6,4,9,1,1,0,0,16096,7.2,19451,230,53,-601,303,23,1609.6
4527079464,1,20,2,1,8,7,12,1,1,0,0,17065,7,18597,229,48,878,460,22.9,1706.5,12,7,0,7,8,8,0,0,0,0,16187,6.8,18137,204,52,-878,-460,20.4,1618.7
4511287504,0,17,3,0,4,4,5,0,0,0,0,15374,7,17614,221,48,405,11,22.1,1537.4,14,2,1,4,4,3,0,0,0,0,14969,6.8,17603,205,56,-405,-11,20.5,1496.9
4526126419,1,17,4,0,8,8,9,2,1,1,0,17882,6.8,17930,205,64,1667,1183,20.5,1788.2,17,2,1,8,8,9,0,0,0,0,16215,6.8,16747,194,36,-1667,-1183,19.4,1621.5
4526346248,1,11,0,1,5,5,5,0,0,0,1,17803,7,18782,242,52,2197,1516,24.2,1780.3,13,1,0,5,5,8,0,0,0,0,15606,6.8,17266,228,37,-2197,-1516,22.8,1560.6
4499619236,0,44,1,0,7,12,12,1,0,1,0,16548,6.8,17321,192,56,-2775,-2872,19.2,1654.8,28,1,1,12,7,10,1,1,0,0,19323,7.4,20193,220,45,2775,2872,22,1932.3
4511513768,1,11,0,1,14,5,9,1,1,0,0,19433,7,18610,213,46,4483,3132,21.3,1943.3,13,1,0,5,14,5,0,0,0,0,14950,6.4,15478,176,49,-4483,-3132,17.6,1495
4516759278,1,21,5,1,8,4,7,1,1,0,1,17790,6.8,17688,190,56,1837,458,19,1779,86,2,0,4,8,4,1,0,1,0,15953,6.8,17230,176,68,-1837,-458,17.6,1595.3
4516124063,0,17,3,1,4,10,7,1,1,0,0,14719,6.6,16802,200,40,-2317,-1800,20,1471.9,16,2,0,10,4,10,1,0,1,0,17036,7,18602,194,45,2317,1800,19.4,1703.6
4515573943,0,14,2,0,7,10,3,0,0,0,0,16418,6.8,17424,199,52,-1517,-62,19.9,1641.8,19,5,1,10,7,14,1,1,0,0,17935,6.8,17486,211,48,1517,62,21.1,1793.5
4524787748,0,18,1,0,5,7,9,0,0,0,0,16566,7.2,18441,216,44,-418,-611,21.6,1656.6,14,3,1,7,5,4,1,1,0,0,16984,7.2,19052,208,58,418,611,20.8,1698.4
4519024034,1,20,3,1,9,5,13,1,0,1,2,20356,7,17899,225,49,5305,382,22.5,2035.6,42,3,0,5,9,10,1,1,0,0,15051,7,17517,184,49,-5305,-382,18.4,1505.1
4527301356,0,13,2,0,10,10,8,1,0,1,0,18524,7,18597,194,58,85,1243,19.4,1852.4,18,3,1,10,10,14,1,1,0,0,18439,6.6,17354,182,47,-85,-1243,18.2,1843.9
4514548275,1,20,4,1,7,3,8,2,1,1,0,17507,7.2,19641,250,64,2790,3073,25,1750.7,169,2,0,3,7,3,0,0,0,0,14717,6.6,16568,209,47,-2790,-3073,20.9,1471.7
4523668637,0,54,2,1,8,4,6,2,1,1,0,16774,7.2,18465,240,48,300,-568,24,1677.4,12,2,0,4,8,5,0,0,0,0,16474,7.4,19033,231,68,-300,568,23.1,1647.4
4500687748,0,16,6,0,3,4,2,1,0,1,0,15527,6.8,18231,223,48,-564,-298,22.3,1552.7,19,4,1,4,3,7,1,1,0,0,16091,7,18529,246,67,564,298,24.6,1609.1
4510701334,0,17,2,0,2,8,1,1,0,1,0,14154,6.8,17350,206,60,-3597,-2757,20.6,1415.4,16,4,1,8,2,5,1,1,0,0,17751,7.2,20107,243,56,3597,2757,24.3,1775.1
4526402561,1,39,5,0,1,4,2,0,0,0,0,14783,7,18120,248,54,-2003,-1370,24.8,1478.3,17,20,1,4,1,6,0,0,0,0,16786,7,19490,264,64,2003,1370,26.4,1678.6
4511593517,1,22,4,0,8,6,7,1,1,0,0,18070,7.2,19549,237,53,1263,590,23.7,1807,50,1,1,6,8,9,0,0,0,0,16807,7.4,18959,205,72,-1263,-590,20.5,1680.7
4518610443,0,18,4,0,6,7,9,1,1,0,0,15689,6.6,17178,171,63,-808,-266,17.1,1568.9,13,3,1,7,6,9,0,0,0,0,16497,6.8,17444,211,52,808,266,21.1,1649.7
4507440061,0,41,4,1,9,6,10,1,1,0,0,17090,7.2,18470,216,44,989,755,21.6,1709,17,2,0,6,9,5,0,0,0,0,16101,6.8,17715,213,56,-989,-755,21.3,1610.1
4526858516,0,18,6,1,1,5,0,1,1,0,0,14524,6.4,16989,234,64,-2527,-1697,23.4,1452.4,18,3,0,5,1,7,1,0,1,0,17051,7,18686,238,42,2527,1697,23.8,1705.1
4513222024,0,16,3,1,3,2,4,1,1,0,0,15496,6.6,16404,238,42,1559,131,23.8,1549.6,15,1,0,2,3,3,1,0,1,0,13937,6.6,16273,197,54,-1559,-131,19.7,1393.7
4525614725,1,15,1,1,8,4,7,0,0,0,0,17972,7.4,19649,254,37,2455,2080,25.4,1797.2,14,0,0,4,8,3,0,0,0,0,15517,6.8,17569,214,57,-2455,-2080,21.4,1551.7
4526220423,0,39,4,0,4,8,5,0,0,0,0,15124,6.6,16323,185,50,-2588,-1355,18.5,1512.4,16,6,1,8,4,9,0,0,0,0,17712,6.8,17678,217,43,2588,1355,21.7,1771.2
4523424930,1,15,6,1,4,4,7,0,0,0,0,16784,7.2,18335,267,47,992,-861,26.7,1678.4,14,2,0,4,4,5,1,1,0,0,15792,7.2,19196,224,80,-992,861,22.4,1579.2
4525971352,0,12,2,0,4,13,3,1,0,1,0,14157,6,15002,158,44,-3948,-4655,15.8,1415.7,15,1,1,13,4,5,1,1,0,0,18105,7.4,19657,243,68,3948,4655,24.3,1810.5
4527157118,1,14,2,0,12,5,10,1,1,0,0,19296,7.4,18995,222,56,3611,2136,22.2,1929.6,15,1,1,5,12,7,0,0,0,0,15685,6.8,16859,180,46,-3611,-2136,18,1568.5
4502220585,1,19,4,1,15,4,23,1,1,0,1,22134,7.6,20809,234,59,8151,5114,23.4,2213.4,15,2,0,4,15,6,0,0,0,0,13983,6.2,15695,176,34,-8151,-5114,17.6,1398.3
4521217676,1,16,3,0,13,9,12,0,0,0,0,18734,7.2,19093,187,55,2355,884,18.7,1873.4,14,1,1,9,13,8,1,1,0,0,16379,6.8,18209,200,56,-2355,-884,20,1637.9
4523654573,1,12,3,1,7,4,6,1,1,0,0,17914,7,18528,240,62,3410,2524,24,1791.4,38,1,0,4,7,7,0,0,0,0,14504,6.4,16004,187,48,-3410,-2524,18.7,1450.4
4525939080,1,15,3,0,10,7,12,0,0,0,0,17892,7,18432,197,52,1017,547,19.7,1789.2,15,2,1,7,10,7,1,1,0,0,16875,7,17885,201,48,-1017,-547,20.1,1687.5
4497564028,1,20,6,0,13,2,13,1,0,1,0,19969,7.2,19752,255,55,6763,6488,25.5,1996.9,15,2,1,2,13,2,0,0,0,0,13206,5.8,13264,192,32,-6763,-6488,19.2,1320.6
4508363234,0,14,3,1,4,8,4,1,1,0,0,16250,6.8,17320,236,49,-1497,-1252,23.6,1625,17,3,0,8,4,13,0,0,0,0,17747,7.2,18572,225,64,1497,1252,22.5,1774.7
4514798405,0,18,2,1,5,6,7,1,1,0,0,15850,6.2,15600,210,51,29,-1552,21,1585,65,4,0,6,5,8,0,0,0,0,15821,6.6,17152,222,31,-29,1552,22.2,1582.1
4513522671,0,16,2,0,6,4,4,1,1,0,0,16505,6.8,18233,245,50,1110,-225,24.5,1650.5,16,2,1,4,6,3,0,0,0,0,15395,7.4,18458,212,58,-1110,225,21.2,1539.5
4524354626,0,22,1,1,9,3,16,1,0,1,0,18741,7.2,19102,243,44,3447,1976,24.3,1874.1,15,3,0,3,9,6,1,1,0,0,15294,6.8,17126,210,68,-3447,-1976,21,1529.4
4522199667,0,10,0,0,8,10,10,0,0,0,0,17051,7,17619,208,42,-530,485,20.8,1705.1,13,3,1,10,8,9,1,1,0,0,17581,6.8,17134,191,40,530,-485,19.1,1758.1
4523011787,1,14,2,1,10,5,12,1,1,0,0,18936,7.2,19738,253,51,4798,5096,25.3,1893.6,19,0,0,5,10,5,0,0,0,0,14138,6,14642,176,36,-4798,-5096,17.6,1413.8
4524303948,0,39,1,0,7,6,7,0,0,0,0,15551,6.4,15956,176,42,-259,-576,17.6,1555.1,14,2,1,6,7,6,0,0,0,0,15810,6.6,16532,173,49,259,576,17.3,1581
4493672467,0,19,0,1,6,8,4,1,1,0,0,16455,7.2,18317,217,56,-411,374,21.7,1645.5,23,3,0,8,6,14,0,0,0,0,16866,7.2,17943,215,49,411,-374,21.5,1686.6
4518444031,0,16,5,1,10,8,12,1,1,0,0,17357,7,18388,191,59,-310,570,19.1,1735.7,27,2,0,8,10,9,1,0,1,0,17667,7.2,17818,194,56,310,-570,19.4,1766.7
4525839513,0,12,4,0,6,4,5,1,0,1,0,16293,7,18893,229,40,929,1008,22.9,1629.3,15,2,1,4,6,5,0,0,0,0,15364,7,17885,227,54,-929,-1008,22.7,1536.4
4506840559,1,30,3,1,6,4,5,1,1,0,0,16541,6.8,17961,211,51,1568,2039,21.1,1654.1,20,3,0,4,6,5,0,0,0,0,14973,6.6,15922,208,46,-1568,-2039,20.8,1497.3
4506029012,1,19,2,1,9,4,11,0,0,0,1,19477,7.2,18390,224,41,5099,2567,22.4,1947.7,17,0,0,4,9,3,1,1,0,0,14378,6.2,15823,176,49,-5099,-2567,17.6,1437.8
4520540286,1,19,6,0,4,5,5,1,1,0,0,16331,7.2,18927,246,60,-462,542,24.6,1633.1,18,5,1,5,4,8,0,0,0,0,16793,6.8,18385,273,49,462,-542,27.3,1679.3
4510908073,0,16,4,0,7,12,4,0,0,0,0,16115,7,17647,193,52,-3032,-1859,19.3,1611.5,14,4,1,12,7,7,0,0,0,0,19147,7.2,19506,243,47,3032,1859,24.3,1914.7
4500852521,0,35,2,1,6,5,6,0,0,0,0,16575,7,18673,233,50,-134,-146,23.3,1657.5,16,3,0,5,6,6,1,1,0,0,16709,7.2,18819,242,68,134,146,24.2,1670.9
4502456299,0,80,1,1,5,5,5,0,0,0,0,15161,6.6,17135,174,40,-106,-827,17.4,1516.1,19,1,0,5,5,5,1,1,0,0,15267,6.8,17962,207,51,106,827,20.7,1526.7
4527675281,0,17,3,0,3,2,6,2,1,1,0,15097,7,17461,226,40,-971,-1447,22.6,1509.7,38,2,1,2,3,2,0,0,0,0,16068,7.2,18908,253,57,971,1447,25.3,1606.8
4518730681,0,13,1,0,7,6,8,2,1,1,0,16514,6.8,17281,216,50,-594,-1344,21.6,1651.4,9,2,1,6,7,11,0,0,0,0,17108,7,18625,242,55,594,1344,24.2,1710.8
4497864725,1,20,7,1,11,2,16,0,0,0,0,19770,7.2,19116,232,48,5120,3137,23.2,1977,16,3,0,2,11,2,2,1,1,0,14650,6.4,15979,191,64,-5120,-3137,19.1,1465
4525924001,1,16,12,1,9,4,8,1,1,0,0,17915,7,19615,225,56,1963,781,22.5,1791.5,36,4,0,4,9,1,0,0,0,0,15952,7.2,18834,258,56,-1963,-781,25.8,1595.2
4513512773,1,15,2,0,5,5,4,0,0,0,0,16450,7.2,18742,222,72,296,1046,22.2,1645,12,4,1,5,5,8,2,1,1,0,16154,7,17696,220,60,-296,-1046,22,1615.4
4527613932,0,12,2,1,6,3,5,0,0,0,0,16007,6.8,17907,221,40,1201,695,22.1,1600.7,12,0,0,3,6,3,1,1,0,0,14806,6.8,17212,209,40,-1201,-695,20.9,1480.6
4526408349,0,17,4,1,4,5,4,2,1,1,0,16552,7.2,18731,227,57,334,145,22.7,1655.2,16,3,0,5,4,9,0,0,0,0,16218,6.8,18586,225,56,-334,-145,22.5,1621.8
4517559119,0,17,2,0,5,5,4,0,0,0,0,15750,6.8,16898,216,49,259,473,21.6,1575,38,4,1,5,5,6,0,0,0,0,15491,6.6,16425,200,43,-259,-473,20,1549.1
4527363053,1,37,2,1,7,4,6,2,1,1,0,17162,7.6,20178,249,44,3035,3792,24.9,1716.2,19,2,0,4,7,3,0,0,0,0,14127,6.6,16386,170,47,-3035,-3792,17,1412.7
4518856826,0,49,4,0,10,13,9,2,1,1,0,17743,7,17923,194,50,-1223,-1046,19.4,1774.3,17,0,1,13,10,10,0,0,0,0,18966,7.2,18969,198,61,1223,1046,19.8,1896.6
4527339142,0,48,1,1,5,4,5,1,1,0,0,15527,6.4,16705,185,44,625,-873,18.5,1552.7,15,1,0,4,5,2,0,0,0,0,14902,7,17578,226,44,-625,873,22.6,1490.2
4510871194,0,38,3,0,4,9,4,0,0,0,0,15585,7.2,18357,216,55,-2017,-659,21.6,1558.5,12,3,1,9,4,12,0,0,0,0,17602,7.2,19016,220,49,2017,659,22,1760.2
4525983895,1,17,2,0,7,2,5,1,0,1,0,17026,6.8,18847,254,40,2439,2360,25.4,1702.6,17,1,1,2,7,2,0,0,0,0,14587,6.6,16487,230,41,-2439,-2360,23,1458.7
4508360116,1,37,3,1,6,5,7,1,1,0,0,16149,7,18253,217,44,-549,-323,21.7,1614.9,15,3,0,5,6,5,0,0,0,0,16698,6.8,18576,233,59,549,323,23.3,1669.8
4511838244,0,11,2,0,1,6,2,0,0,0,0,13728,6.8,17193,204,48,-3675,-2454,20.4,1372.8,83,1,1,6,1,5,0,0,0,0,17403,7.2,19647,240,56,3675,2454,24,1740.3
4515607398,1,19,2,0,8,3,7,1,1,0,0,18003,7.4,20207,248,77,3034,1983,24.8,1800.3,15,4,1,3,8,2,0,0,0,0,14969,7,18224,211,52,-3034,-1983,21.1,1496.9
4508344730,1,16,1,1,7,6,10,1,1,0,0,16497,7,17789,201,57,787,-575,20.1,1649.7,17,3,0,6,7,2,0,0,0,0,15710,7,18364,232,42,-787,575,23.2,1571
4519023406,0,15,14,0,9,6,10,0,0,0,0,17666,6.4,17054,195,50,846,-28,19.5,1766.6,37,2,1,6,9,8,0,0,0,0,16820,6.8,17082,247,40,-846,28,24.7,1682
4524668512,1,19,5,1,6,9,8,1,0,1,0,16711,7,17375,217,52,-927,-200,21.7,1671.1,18,3,0,9,6,10,1,1,0,0,17638,6.8,17575,229,46,927,200,22.9,1763.8
4526039823,0,14,4,1,5,6,5,1,1,0,0,15414,6.8,17454,208,48,-599,-288,20.8,1541.4,16,1,0,6,5,5,0,0,0,0,16013,6.8,17742,218,50,599,288,21.8,1601.3
4518118061,0,18,3,0,13,10,17,0,0,0,0,19372,7,18078,201,47,1734,1173,20.1,1937.2,15,2,1,10,13,17,1,1,0,0,17638,6.6,16905,195,40,-1734,-1173,19.5,1763.8
4510115879,0,18,2,0,4,12,6,0,0,0,0,15207,6.6,16955,213,44,-5324,-2914,21.3,1520.7,16,1,1,12,4,12,2,1,1,1,20531,7.2,19869,205,64,5324,2914,20.5,2053.1
4518384119,1,17,3,0,7,15,11,0,0,0,0,16378,6.4,16097,189,48,-4552,-4208,18.9,1637.8,16,5,1,15,7,20,1,1,0,0,20930,7.4,20305,234,56,4552,4208,23.4,2093
4508242433,1,84,3,1,7,2,9,1,1,0,0,16683,7.2,19168,223,60,1828,2134,22.3,1668.3,17,1,0,2,7,4,0,0,0,0,14855,6.8,17034,224,44,-1828,-2134,22.4,1485.5
4508781088,1,16,2,0,7,7,7,1,0,1,0,17215,7,18989,256,47,324,2076,25.6,1721.5,19,5,1,7,7,13,0,0,0,0,16891,6.6,16913,234,42,-324,-2076,23.4,1689.1
4508196415,0,17,4,0,7,9,7,0,0,0,0,17177,6.8,18796,228,68,-1885,-210,22.8,1717.7,20,3,1,9,7,10,1,1,0,0,19062,7.2,19006,236,56,1885,210,23.6,1906.2
4520393840,0,18,3,1,9,7,13,1,1,0,0,17682,6.6,17214,195,51,724,241,19.5,1768.2,40,3,0,7,9,9,0,0,0,0,16958,6.6,16973,229,48,-724,-241,22.9,1695.8
4520307330,0,13,1,0,10,6,10,0,0,0,0,16744,7,19007,183,42,-645,426,18.3,1674.4,13,1,1,6,10,3,0,0,0,0,17389,7,18581,224,52,645,-426,22.4,1738.9
4527034667,0,17,2,0,8,5,10,1,0,1,0,17812,7,19113,234,41,2554,2046,23.4,1781.2,13,3,1,5,8,4,1,1,0,0,15258,6.6,17067,212,35,-2554,-2046,21.2,1525.8
4526945027,0,15,3,0,1,6,1,0,0,0,0,14971,6.6,17477,255,55,-1390,-446,25.5,1497.1,16,2,1,6,1,4,2,1,1,0,16361,6.8,17923,226,52,1390,446,22.6,1636.1
4527398202,0,64,4,0,7,9,13,1,1,0,0,17432,7,17080,200,52,-399,-1348,20,1743.2,29,4,1,9,7,11,0,0,0,0,17831,7,18428,203,48,399,1348,20.3,1783.1
4527693683,1,12,1,0,3,5,3,1,0,1,0,15341,6.8,18065,215,59,-85,1665,21.5,1534.1,16,3,1,5,3,9,1,1,0,0,15426,6.6,16400,202,40,85,-1665,20.2,1542.6
4518352378,1,17,3,1,6,1,6,0,0,0,0,17357,7.2,19151,234,51,4111,2823,23.4,1735.7,22,1,0,1,6,0,1,1,0,0,13246,6.6,16328,208,53,-4111,-2823,20.8,1324.6
4502759041,0,17,6,0,2,4,2,0,0,0,0,14747,6.8,18401,245,47,-1356,-501,24.5,1474.7,17,2,1,4,2,3,1,1,0,0,16103,7,18902,261,48,1356,501,26.1,1610.3
4525324183,0,15,3,0,6,5,9,1,1,0,0,15368,6.4,16039,169,55,71,-679,16.9,1536.8,16,2,1,5,6,2,0,0,0,0,15297,6.4,16718,198,51,-71,679,19.8,1529.7
4510783393,1,18,2,1,5,2,5,1,1,0,0,15931,7,17840,231,49,393,111,23.1,1593.1,16,2,0,2,5,3,0,0,0,0,15538,6.8,17729,255,51,-393,-111,25.5,1553.8
4508869130,0,15,1,0,8,8,5,0,0,0,0,17188,6.6,17474,229,35,809,645,22.9,1718.8,11,1,1,8,8,10,1,0,1,0,16379,6.6,16829,191,47,-809,-645,19.1,1637.9
4526830750,1,19,3,0,7,6,12,1,1,0,0,17737,7,18873,220,48,1126,549,22,1773.7,51,0,1,6,7,10,0,0,0,0,16611,7.2,18324,228,55,-1126,-549,22.8,1661.1
4513659077,1,16,3,0,4,4,3,1,1,0,0,15024,7,17340,217,49,-1243,-1261,21.7,1502.4,15,3,1,4,4,6,1,0,1,0,16267,7,18601,221,62,1243,1261,22.1,1626.7
4525999978,1,15,15,0,12,5,11,1,0,1,0,19659,7.2,19474,241,48,3745,1627,24.1,1965.9,27,3,1,5,12,6,0,0,0,0,15914,7,17847,230,53,-3745,-1627,23,1591.4
4513108171,0,14,1,1,8,7,8,1,0,1,0,17562,6.8,18086,203,49,1269,739,20.3,1756.2,14,2,0,7,8,9,1,1,0,0,16293,6.8,17347,199,48,-1269,-739,19.9,1629.3
4512127012,0,11,1,0,3,8,5,1,1,0,0,14527,6.4,16646,221,44,-4267,-2746,22.1,1452.7,15,2,1,8,3,8,1,0,1,1,18794,7.2,19392,238,68,4267,2746,23.8,1879.4
4525780504,0,13,2,0,3,2,6,0,0,0,0,14509,6.8,16800,191,52,-1749,-1247,19.1,1450.9,16,3,1,2,3,3,2,1,1,0,16258,6.8,18047,251,65,1749,1247,25.1,1625.8
4527089557,1,17,1,1,9,2,8,1,0,1,0,18650,7.4,20053,234,55,4128,3128,23.4,1865,17,2,0,2,9,2,0,0,0,0,14522,6.6,16925,243,45,-4128,-3128,24.3,1452.2
4524112117,1,40,1,1,7,4,8,0,0,0,0,15818,6.6,16786,205,36,656,-439,20.5,1581.8,19,3,0,4,7,3,0,0,0,0,15162,6.8,17225,200,53,-656,439,20,1516.2
4526621303,0,19,1,0,5,5,4,1,0,1,0,15550,6.8,17793,218,43,-1324,-615,21.8,1555,16,4,1,5,5,7,1,1,0,0,16874,6.8,18408,257,64,1324,615,25.7,1687.4
4519708625,0,14,3,1,7,5,9,0,0,0,0,16655,7.2,18948,208,50,791,1064,20.8,1665.5,34,1,0,5,7,6,2,1,1,0,15864,6.8,17884,212,58,-791,-1064,21.2,1586.4
4515744642,1,19,4,0,2,6,2,0,0,0,0,14790,6.8,18612,223,71,-3075,-244,22.3,1479,16,0,1,6,2,7,1,1,0,0,17865,7,18856,266,47,3075,244,26.6,1786.5
4527275742,1,22,2,1,7,3,10,0,0,0,0,17755,7.2,19403,254,48,2864,3193,25.4,1775.5,14,3,0,3,7,3,0,0,0,0,14891,6.4,16210,221,41,-2864,-3193,22.1,1489.1
4523315311,1,16,1,1,8,5,7,2,1,1,1,17973,7,17436,223,44,2038,1029,22.3,1797.3,11,2,0,5,8,6,0,0,0,0,15935,6.4,16407,207,44,-2038,-1029,20.7,1593.5
4527078434,0,17,2,1,5,6,10,1,0,1,0,14566,6.4,16031,182,37,-2061,-2046,18.2,1456.6,11,0,0,6,5,7,1,1,0,0,16627,7,18077,200,50,2061,2046,20,1662.7
4526755207,1,19,2,1,5,4,8,1,1,0,0,15983,6.8,17134,219,50,544,-289,21.9,1598.3,13,5,0,4,5,6,0,0,0,0,15439,6.8,17423,218,49,-544,289,21.8,1543.9
4508028772,0,13,2,0,6,5,4,1,1,0,0,15655,6.8,17386,203,53,-693,-919,20.3,1565.5,14,1,1,5,6,5,0,0,0,0,16348,7,18305,234,56,693,919,23.4,1634.8
4521868981,1,17,2,1,8,3,7,0,0,0,0,17840,6.8,18356,233,40,3047,1616,23.3,1784,19,6,0,3,8,3,1,1,0,0,14793,6.6,16740,229,54,-3047,-1616,22.9,1479.3
4518559997,0,17,0,1,4,5,3,2,1,1,0,16018,7.2,18223,215,68,-599,192,21.5,1601.8,17,5,0,5,4,10,0,0,0,0,16617,6.8,18031,242,48,599,-192,24.2,1661.7
4527592753,1,19,1,0,1,6,1,0,0,0,0,13719,6.4,15044,213,31,-3247,-3783,21.3,1371.9,14,2,1,6,1,5,2,1,1,0,16966,7.2,18827,237,58,3247,3783,23.7,1696.6
4512245409,1,14,1,0,9,6,9,0,0,0,0,17633,7.2,18808,206,54,1703,1809,20.6,1763.3,16,1,1,6,9,7,0,0,0,0,15930,6.8,16999,210,40,-1703,-1809,21,1593
4520348374,1,24,3,1,6,6,12,0,0,0,1,17552,6.8,16611,201,45,1189,-821,20.1,1755.2,97,5,0,6,6,5,1,0,1,0,16363,6.8,17432,191,55,-1189,821,19.1,1636.3
4525626729,1,15,4,1,16,7,14,1,1,0,0,20236,6.8,18074,203,40,3424,1464,20.3,2023.6,15,1,0,7,16,6,0,0,0,0,16812,6.6,16610,169,48,-3424,-1464,16.9,1681.2
4517721680,1,16,3,0,2,7,4,1,1,0,0,14558,6.8,17024,206,63,-2564,-1959,20.6,1455.8,18,3,1,7,2,8,1,0,1,0,17122,7.2,18983,222,48,2564,1959,22.2,1712.2
4526401078,0,11,1,0,4,3,3,1,1,0,0,15080,7,18378,208,56,-401,-439,20.8,1508,37,1,1,3,4,3,0,0,0,0,15481,7.4,18817,232,53,401,439,23.2,1548.1
4510990676,1,19,2,1,10,2,12,1,0,1,0,19621,7.6,19733,209,56,6703,5604,20.9,1962.1,18,3,0,2,10,2,0,0,0,0,12918,5.8,14129,140,58,-6703,-5604,14,1291.8
4502473645,1,22,3,0,3,5,3,0,0,0,0,15970,7,18425,245,59,24,-286,24.5,1597,18,1,1,5,3,1,0,0,0,0,15946,6.8,18711,249,53,-24,286,24.9,1594.6
4512380043,0,16,2,0,4,5,2,1,1,0,0,15581,7,18725,239,58,-460,935,23.9,1558.1,12,4,1,5,4,4,1,0,1,0,16041,7,17790,223,46,460,-935,22.3,1604.1
4524224668,1,21,2,1,13,3,14,0,0,0,1,21278,7.4,20007,253,38,6968,4379,25.3,2127.8,12,2,0,3,13,2,1,1,0,0,14310,6.6,15628,185,55,-6968,-4379,18.5,1431
4508478137,1,14,5,1,6,3,8,1,1,0,0,17352,6.8,18631,257,63,1963,804,25.7,1735.2,45,2,0,3,6,7,0,0,0,0,15389,6.8,17827,210,52,-1963,-804,21,1538.9
4526837862,1,14,2,1,4,7,6,1,0,1,0,15289,7,16623,210,52,-1041,-1114,21,1528.9,10,1,0,7,4,5,1,1,0,0,16330,6.8,17737,196,52,1041,1114,19.6,1633
4515418591,1,15,4,1,7,2,6,1,0,1,1,17819,7.2,19319,236,44,2979,1183,23.6,1781.9,18,1,0,2,7,1,1,1,0,0,14840,7,18136,223,72,-2979,-1183,22.3,1484
4517529654,1,22,15,1,7,3,9,1,0,1,0,16723,7,17883,233,34,1489,604,23.3,1672.3,41,5,0,3,7,3,0,0,0,0,15234,7,17279,228,65,-1489,-604,22.8,1523.4
4510180756,0,35,3,1,8,4,11,1,1,0,0,17857,7.2,19272,239,51,2374,1332,23.9,1785.7,16,3,0,4,8,3,0,0,0,0,15483,7,17940,239,52,-2374,-1332,23.9,1548.3
4525584970,0,16,1,1,7,5,10,1,0,1,0,16940,6.8,16731,232,40,1523,-576,23.2,1694,14,3,0,5,7,6,1,1,0,0,15417,6.8,17307,185,58,-1523,576,18.5,1541.7
4512105521,0,16,4,0,9,6,9,1,1,0,0,17059,7,18302,214,52,977,1247,21.4,1705.9,16,1,1,6,9,5,0,0,0,0,16082,6.6,17055,203,52,-977,-1247,20.3,1608.2
4517748188,0,78,1,1,4,6,5,0,0,0,0,15593,6.6,17750,225,46,-416,-1639,22.5,1559.3,54,3,0,6,4,6,1,1,0,0,16009,7.2,19389,221,51,416,1639,22.1,1600.9
4523595695,1,24,3,0,6,5,12,0,0,0,0,17074,7.2,18861,242,64,519,1436,24.2,1707.4,62,3,1,5,6,7,1,1,0,0,16555,6.6,17425,232,52,-519,-1436,23.2,1655.5
4525345831,1,17,0,1,7,6,4,0,0,0,0,16466,6.8,16798,185,52,59,-305,18.5,1646.6,12,4,0,6,7,10,2,1,1,0,16407,7,17103,210,53,-59,305,21,1640.7
4518273376,1,14,2,0,12,3,11,2,1,1,0,19082,7.2,18970,226,52,4305,2244,22.6,1908.2,38,1,1,3,12,2,0,0,0,0,14777,6.6,16726,216,44,-4305,-2244,21.6,1477.7
4525792479,1,40,3,1,6,6,8,1,1,0,0,16961,6.8,17778,238,48,-33,-998,23.8,1696.1,15,13,0,6,6,4,1,0,1,0,16994,7,18776,213,58,33,998,21.3,1699.4
4511051956,0,18,3,1,5,5,4,0,0,0,0,16864,7,18195,247,51,874,-554,24.7,1686.4,17,2,0,5,5,5,2,1,1,0,15990,7.2,18749,232,56,-874,554,23.2,1599
4502376872,0,18,1,0,5,9,6,0,0,0,0,14988,6.6,16513,200,40,-2824,-2021,20,1498.8,16,4,1,9,5,10,0,0,0,0,17812,6.8,18534,222,56,2824,2021,22.2,1781.2
4519132891,1,39,2,0,13,10,13,0,0,0,0,18886,7.2,18539,188,56,845,1049,18.8,1888.6,13,1,1,10,13,7,0,0,0,0,18041,7,17490,214,39,-845,-1049,21.4,1804.1
4518083698,1,16,2,1,2,6,6,0,0,0,0,15223,6.8,17348,213,64,-713,-897,21.3,1522.3,12,2,0,6,2,3,0,0,0,0,15936,6.8,18245,228,44,713,897,22.8,1593.6
4523827809,1,26,4,0,5,3,6,2,1,1,0,15947,7,18280,219,64,402,890,21.9,1594.7,14,5,1,3,5,3,0,0,0,0,15545,7,17390,237,55,-402,-890,23.7,1554.5
4509664534,0,15,2,1,4,5,1,0,0,0,0,14473,6.8,17358,185,53,-2485,-1570,18.5,1447.3,31,2,0,5,4,2,1,1,0,0,16958,7.2,18928,263,54,2485,1570,26.3,1695.8
4516781152,0,12,4,1,7,4,5,1,1,0,0,17214,7,19173,235,48,1746,2273,23.5,1721.4,14,4,0,4,7,6,0,0,0,0,15468,6.8,16900,205,56,-1746,-2273,20.5,1546.8
4498270130,0,39,1,0,3,9,6,0,0,0,0,14515,6.6,16542,175,64,-4152,-1948,17.5,1451.5,18,9,1,9,3,14,1,1,0,0,18667,7,18490,253,40,4152,1948,25.3,1866.7
4526135589,0,21,3,0,7,6,8,1,1,0,0,15463,6.8,16652,161,72,-1846,-1362,16.1,1546.3,44,3,1,6,7,3,1,0,1,1,17309,7,18014,194,48,1846,1362,19.4,1730.9
4517856513,0,21,5,0,4,10,7,0,0,0,0,15032,6.6,16564,203,44,-4481,-1530,20.3,1503.2,22,8,1,10,4,19,1,1,0,1,19513,7,18094,245,45,4481,1530,24.5,1951.3
4511313757,0,13,0,0,4,13,4,0,0,0,0,14979,6.6,16961,194,46,-4686,-2937,19.4,1497.9,14,1,1,13,4,13,1,1,0,0,19665,7.4,19898,208,47,4686,2937,20.8,1966.5
4521333183,0,17,1,0,1,2,2,0,0,0,0,13863,6.8,17182,219,40,-1336,-1242,21.9,1386.3,16,3,1,2,1,1,1,1,0,0,15199,7,18424,226,75,1336,1242,22.6,1519.9
4526400961,1,80,4,1,4,1,7,0,0,0,0,15736,7.2,18522,216,56,2112,2566,21.6,1573.6,17,2,0,1,4,2,1,1,0,0,13624,6.6,15956,197,60,-2112,-2566,19.7,1362.4
4523291821,0,11,1,1,5,6,5,0,0,0,0,15978,6.8,17338,225,50,455,-1138,22.5,1597.8,15,2,0,6,5,7,0,0,0,0,15523,7,18476,191,40,-455,1138,19.1,1552.3
4503341875,0,22,2,1,9,7,10,0,0,0,0,18400,7.2,18909,221,60,2746,1975,22.1,1840,39,1,0,7,9,10,1,1,0,0,15654,6.6,16934,164,52,-2746,-1975,16.4,1565.4
4498216793,0,38,6,0,6,10,6,2,1,1,0,15573,6.8,18078,194,43,-4673,-1225,19.4,1557.3,19,2,1,10,6,10,0,0,0,1,20246,7.2,19303,246,50,4673,1225,24.6,2024.6
4515606448,0,15,2,0,4,6,7,1,1,0,0,15520,7,17369,207,59,-1949,-1983,20.7,1552,37,2,1,6,4,10,1,0,1,0,17469,7.2,19352,230,56,1949,1983,23,1746.9
4519509800,0,17,2,1,2,9,3,0,0,0,0,13367,6.4,15834,157,52,-4081,-1994,15.7,1336.7,19,5,0,9,2,11,1,1,0,0,17448,7.2,17828,216,44,4081,1994,21.6,1744.8
4497961157,1,14,2,0,10,5,7,1,1,0,0,17687,6.8,18625,213,56,2159,2100,21.3,1768.7,15,2,1,5,10,5,0,0,0,0,15528,6.8,16525,180,52,-2159,-2100,18,1552.8
4526622617,1,19,3,0,11,8,8,0,0,0,0,17663,6.6,16879,193,30,16,-639,19.3,1766.3,15,4,1,8,11,6,2,1,1,0,17647,7,17518,227,42,-16,639,22.7,1764.7
4516123814,0,22,0,0,6,10,5,0,0,0,0,16108,6.4,16262,211,42,-1701,-771,21.1,1610.8,16,2,1,10,6,16,0,0,0,0,17809,6.8,17033,190,52,1701,771,19,1780.9
4525978244,1,13,3,0,3,3,5,1,1,0,0,14697,6.6,16968,229,44,-780,-1068,22.9,1469.7,15,2,1,3,3,3,1,0,1,0,15477,7,18036,236,59,780,1068,23.6,1547.7
4508688616,0,11,6,0,5,9,4,0,0,0,0,15106,7,17323,200,36,-2793,83,20,1510.6,21,3,1,9,5,12,1,0,1,0,17899,6.8,17240,215,35,2793,-83,21.5,1789.9
4520868941,0,16,2,1,7,3,12,0,0,0,0,16175,6.6,16320,202,45,1426,524,20.2,1617.5,13,0,0,3,7,2,0,0,0,0,14749,6.6,15796,204,53,-1426,-524,20.4,1474.9
4521879748,1,12,2,1,10,8,10,1,1,0,0,18787,7,18529,231,48,1876,1668,23.1,1878.7,56,3,0,8,10,10,0,0,0,0,16911,6.8,16861,203,28,-1876,-1668,20.3,1691.1
4509868261,1,12,3,0,9,3,10,0,0,0,0,17460,7,17575,217,40,2338,1009,21.7,1746,14,1,1,3,9,3,1,0,1,0,15122,6.6,16566,192,52,-2338,-1009,19.2,1512.2
4514563182,0,18,1,0,9,5,5,1,0,1,0,16835,6.8,17752,200,48,606,533,20,1683.5,13,3,1,5,9,6,0,0,0,0,16229,6.8,17219,211,55,-606,-533,21.1,1622.9
4525869315,0,15,4,0,8,10,11,2,1,1,0,17351,6.6,16649,204,44,-780,63,20.4,1735.1,26,4,1,10,8,14,0,0,0,0,18131,6.8,16586,193,52,780,-63,19.3,1813.1
4512531903,1,17,2,1,6,2,4,0,0,0,0,16412,7,17900,235,47,1211,751,23.5,1641.2,14,6,0,2,6,2,1,1,0,0,15201,6.6,17149,249,52,-1211,-751,24.9,1520.1
4526023571,1,17,0,0,5,4,8,1,0,1,0,15040,6.8,18066,197,44,-1964,-963,19.7,1504,11,1,1,4,5,4,0,0,0,0,17004,7.2,19029,260,72,1964,963,26,1700.4
4525350807,0,14,3,0,5,4,3,0,0,0,0,16293,6.8,17793,218,55,1006,1171,21.8,1629.3,17,2,1,4,5,5,1,1,0,0,15287,6.6,16622,207,52,-1006,-1171,20.7,1528.7
4509704397,0,16,6,0,6,4,5,1,1,0,0,16249,6.8,18007,221,40,444,1056,22.1,1624.9,23,3,1,4,6,4,1,0,1,0,15805,7,16951,213,51,-444,-1056,21.3,1580.5
4516719935,1,13,2,0,2,4,2,1,1,0,0,15312,7,18210,250,61,-961,-725,25,1531.2,16,4,1,4,2,3,0,0,0,0,16273,7.2,18935,250,56,961,725,25,1627.3
4519804931,1,14,3,1,6,3,6,1,1,0,0,16432,7,18560,240,44,1804,1547,24,1643.2,33,2,0,3,6,3,0,0,0,0,14628,6.8,17013,200,43,-1804,-1547,20,1462.8
4521903863,1,40,3,1,8,3,10,2,1,1,0,18122,7.4,20449,247,68,2696,3081,24.7,1812.2,12,14,0,3,8,3,0,0,0,0,15426,6.8,17368,222,54,-2696,-3081,22.2,1542.6
4526903183,0,85,2,0,6,9,7,0,0,0,0,16223,6.8,17056,196,36,-605,-782,19.6,1622.3,13,2,1,9,6,7,1,1,0,0,16828,7,17838,203,56,605,782,20.3,1682.8
4515683822,0,13,2,0,6,8,7,1,1,0,0,16326,6.8,17923,236,40,-1114,-417,23.6,1632.6,33,2,1,8,6,12,0,0,0,0,17440,7,18340,241,47,1114,417,24.1,1744
4508915149,0,14,1,0,0,5,0,0,0,0,0,13561,6.6,16518,220,51,-1958,-1775,22,1356.1,15,3,1,5,0,4,1,1,0,0,15519,7,18293,223,37,1958,1775,22.3,1551.9
4420933848,1,12,2,0,5,6,3,0,0,0,0,15897,6.8,18131,219,53,-453,659,21.9,1589.7,49,1,1,6,5,10,1,1,0,0,16350,7,17472,188,48,453,-659,18.8,1635
4516833244,0,15,2,0,6,8,6,1,0,1,0,16005,6.6,17346,188,58,-1205,-1042,18.8,1600.5,17,4,1,8,6,6,1,1,0,0,17210,7.2,18388,232,34,1205,1042,23.2,1721
4525957612,0,16,1,1,5,6,6,1,1,0,0,15907,6.6,16474,211,67,-393,-2719,21.1,1590.7,19,5,0,6,5,9,0,0,0,0,16300,7,19193,211,56,393,2719,21.1,1630
4527528419,0,13,6,1,9,2,12,0,0,0,0,17440,7,18112,213,36,3422,1091,21.3,1744,44,1,0,2,9,1,0,0,0,0,14018,6.8,17021,216,56,-3422,-1091,21.6,1401.8
4510187946,0,12,3,0,1,5,2,0,0,0,0,14257,6.6,17053,230,44,-3234,-2889,23,1425.7,17,3,1,5,1,9,0,0,0,0,17491,7.2,19942,247,68,3234,2889,24.7,1749.1
4516722910,0,15,1,0,7,10,11,0,0,0,0,15723,6.4,15809,159,44,-4307,-2260,15.9,1572.3,17,0,1,10,7,13,1,0,1,1,20030,7,18069,253,40,4307,2260,25.3,2003
4515957232,0,52,2,0,2,10,1,0,0,0,0,14817,6.4,16953,212,60,-3264,-1507,21.2,1481.7,16,2,1,10,2,11,1,1,0,0,18081,7,18460,211,40,3264,1507,21.1,1808.1
4508218503,0,14,1,0,0,1,0,0,0,0,0,14713,7,17547,261,53,-388,-1004,26.1,1471.3,10,4,1,1,0,1,1,1,0,0,15101,7,18551,264,56,388,1004,26.4,1510.1
4523938841,0,27,7,0,6,6,11,0,0,0,0,16319,6.6,17353,214,39,52,554,21.4,1631.9,18,8,1,6,6,6,1,0,1,0,16267,6.6,16799,235,36,-52,-554,23.5,1626.7
4526197736,0,38,1,0,10,8,14,1,1,0,0,18294,7.4,18581,204,43,1058,527,20.4,1829.4,12,1,1,8,10,12,0,0,0,0,17236,7,18054,210,46,-1058,-527,21,1723.6
4526110016,0,14,2,0,3,7,2,0,0,0,0,14415,6.8,17890,213,61,-3505,-1473,21.3,1441.5,18,3,1,7,3,9,1,1,0,0,17920,7.2,19363,226,70,3505,1473,22.6,1792
4524668362,0,15,1,1,10,6,17,0,0,0,0,17634,6.6,16665,193,35,2031,1004,19.3,1763.4,18,1,0,6,10,6,0,0,0,0,15603,6.4,15661,196,38,-2031,-1004,19.6,1560.3
4525216073,1,18,1,0,6,2,7,1,1,0,0,17062,7.2,20216,235,64,2436,2608,23.5,1706.2,12,5,1,2,6,3,1,0,1,0,14626,7,17608,203,60,-2436,-2608,20.3,1462.6
4488817314,0,16,3,1,12,9,20,0,0,0,0,19098,7,18390,230,36,1769,2294,23,1909.8,16,2,0,9,12,14,1,1,0,0,17329,6.4,16096,166,60,-1769,-2294,16.6,1732.9
4520017267,0,10,2,1,8,12,8,0,0,0,0,17237,7,18392,213,41,-1133,-714,21.3,1723.7,57,0,0,12,8,12,1,1,0,0,18370,7.4,19106,196,46,1133,714,19.6,1837
4508074123,1,17,3,1,10,6,8,0,0,0,0,18093,7.4,18871,222,42,1864,1877,22.2,1809.3,18,3,0,6,10,7,1,1,0,0,16229,6.6,16994,189,62,-1864,-1877,18.9,1622.9
4511419534,0,15,4,1,7,7,9,0,0,0,0,16276,6.6,17546,215,40,273,-1195,21.5,1627.6,16,3,0,7,7,2,1,0,1,0,16003,7.2,18741,196,48,-273,1195,19.6,1600.3
4507747871,1,18,1,1,6,5,6,0,0,0,0,16471,6.8,17952,246,36,1450,763,24.6,1647.1,18,2,0,5,6,3,0,0,0,0,15021,6.8,17189,200,40,-1450,-763,20,1502.1
4510883651,0,18,0,1,6,11,5,0,0,0,0,15246,6.4,15419,151,42,-4370,-4504,15.1,1524.6,16,5,0,11,6,12,1,1,0,0,19616,7.2,19923,235,51,4370,4504,23.5,1961.6
4525786511,1,18,4,0,8,2,10,1,0,1,1,18656,7.2,19071,229,45,3761,1269,22.9,1865.6,37,3,1,2,8,2,0,0,0,0,14895,6.6,17802,241,52,-3761,-1269,24.1,1489.5
4500845226,1,18,4,1,5,1,5,2,1,1,0,16951,7.2,18681,270,43,1341,-85,27,1695.1,77,4,0,1,5,1,0,0,0,0,15610,7.2,18766,254,76,-1341,85,25.4,1561
4519568491,1,16,1,0,7,5,8,0,0,0,0,17830,7,18550,214,55,1299,8,21.4,1783,12,3,1,5,7,4,2,1,1,0,16531,7.2,18542,217,64,-1299,-8,21.7,1653.1
4515648719,0,46,2,1,11,8,13,0,0,0,0,16886,6.6,16618,172,39,-2107,-1458,17.2,1688.6,14,0,0,8,11,8,1,1,0,0,18993,7.2,18076,189,60,2107,1458,18.9,1899.3
4526919278,0,18,4,1,4,3,5,1,1,0,0,16122,6.8,17673,223,44,385,-1446,22.3,1612.2,16,5,0,3,4,2,1,0,1,0,15737,7.2,19119,240,64,-385,1446,24,1573.7
4523554856,1,19,2,1,7,6,7,0,0,0,1,19367,7.2,19595,259,61,4507,2090,25.9,1936.7,11,3,0,6,7,2,1,1,0,0,14860,6.8,17505,202,45,-4507,-2090,20.2,1486
4510986413,1,18,1,1,9,2,8,1,0,1,1,20027,7.2,19439,257,55,6790,4889,25.7,2002.7,17,3,0,2,9,4,1,1,0,0,13237,6.2,14550,165,49,-6790,-4889,16.5,1323.7
4525594004,0,22,3,1,12,10,16,1,0,1,0,19784,7,18582,241,41,1680,473,24.1,1978.4,19,5,0,10,12,16,0,0,0,0,18104,7,18109,197,35,-1680,-473,19.7,1810.4
4503836922,1,41,3,0,3,5,3,1,1,0,0,15118,7.2,18628,222,63,-769,891,22.2,1511.8,13,3,1,5,3,9,1,0,1,0,15887,7,17737,208,56,769,-891,20.8,1588.7
4500568254,1,14,3,1,6,3,6,0,0,0,0,16195,7,17940,214,35,2254,1870,21.4,1619.5,14,1,0,3,6,1,0,0,0,0,13941,6.2,16070,193,56,-2254,-1870,19.3,1394.1
4515517372,1,17,5,0,2,2,2,0,0,0,0,15423,6.8,18333,227,60,699,753,22.7,1542.3,16,2,1,2,2,3,1,1,0,0,14724,6.8,17580,232,46,-699,-753,23.2,1472.4
4527240593,0,38,1,1,9,5,8,0,0,0,0,18174,7,18815,232,55,3242,2227,23.2,1817.4,34,3,0,5,9,7,1,1,0,0,14932,6.8,16588,191,40,-3242,-2227,19.1,1493.2
4526904265,1,17,1,1,7,4,6,0,0,0,0,16649,7,17555,212,52,1535,220,21.2,1664.9,11,2,0,4,7,4,2,1,1,0,15114,7,17335,222,53,-1535,-220,22.2,1511.4
4524535912,1,14,0,1,9,8,9,0,0,0,0,16818,6.6,16998,208,44,-141,222,20.8,1681.8,14,0,0,8,9,11,1,1,0,0,16959,6.8,16776,164,48,141,-222,16.4,1695.9
4515240006,0,16,5,0,5,10,8,0,0,0,0,15829,6.8,17626,236,53,-3567,-1828,23.6,1582.9,18,4,1,10,5,11,2,1,1,1,19396,7.2,19454,234,49,3567,1828,23.4,1939.6
4527159489,0,15,1,0,3,4,3,0,0,0,0,15604,7,18013,227,65,-557,625,22.7,1560.4,16,1,1,4,3,6,2,1,1,0,16161,6.8,17388,216,57,557,-625,21.6,1616.1
4522587256,1,15,3,0,4,11,3,0,0,0,0,14927,6.4,16195,195,44,-2597,-1718,19.5,1492.7,20,3,1,11,4,10,1,1,0,0,17524,7,17913,221,46,2597,1718,22.1,1752.4
4505233035,1,39,0,1,5,7,4,0,0,0,0,16247,6.8,17790,189,52,-820,-575,18.9,1624.7,16,5,0,7,5,6,1,1,0,0,17067,7,18365,222,57,820,575,22.2,1706.7
4511813987,1,35,18,1,14,5,11,1,1,0,0,20070,7.2,20194,211,65,4235,3837,21.1,2007,42,3,0,5,14,8,0,0,0,0,15835,6.6,16357,188,34,-4235,-3837,18.8,1583.5
4492974122,0,18,4,1,5,4,6,0,0,0,0,16166,7,17990,198,47,180,-192,19.8,1616.6,18,4,0,4,5,2,1,1,0,0,15986,7,18182,212,80,-180,192,21.2,1598.6
4527354441,0,37,17,0,3,5,2,0,0,0,0,15630,7,18378,254,48,-1092,-324,25.4,1563,36,3,1,5,3,7,0,0,0,0,16722,7,18702,264,44,1092,324,26.4,1672.2
4522421841,1,20,2,1,8,7,11,1,1,0,1,18744,6.8,18677,210,55,2858,1988,21,1874.4,14,2,0,7,8,7,0,0,0,0,15886,6.8,16689,174,56,-2858,-1988,17.4,1588.6
4509392638,0,18,3,1,5,9,4,0,0,0,0,15815,7,18120,202,56,-2234,-1264,20.2,1581.5,18,3,0,9,5,8,2,1,1,0,18049,7.4,19384,258,48,2234,1264,25.8,1804.9
4527516350,1,25,2,1,6,7,6,0,0,0,0,16246,7,17593,193,45,-766,-577,19.3,1624.6,15,3,0,7,6,9,1,1,0,0,17012,7.2,18170,204,61,766,577,20.4,1701.2
4521334344,0,13,2,1,5,6,4,0,0,0,0,15701,7,17899,212,42,-662,-951,21.2,1570.1,14,3,0,6,5,3,2,1,1,0,16363,7,18850,243,52,662,951,24.3,1636.3
4513796211,0,14,0,0,8,12,5,0,0,0,0,16024,7,17294,212,46,-2370,-2104,21.2,1602.4,18,3,1,12,8,10,1,1,0,0,18394,7.4,19398,194,61,2370,2104,19.4,1839.4
4511029912,0,82,4,1,6,13,2,0,0,0,0,15539,6.8,17438,202,48,-4311,-2532,20.2,1553.9,19,4,0,13,6,14,1,1,0,0,19850,7.4,19970,234,55,4311,2532,23.4,1985
4506803451,1,16,4,1,11,2,8,1,1,0,0,19038,7.4,20256,252,46,4090,2523,25.2,1903.8,14,3,0,2,11,3,0,0,0,0,14948,7,17733,214,68,-4090,-2523,21.4,1494.8
4516581221,1,58,2,1,5,7,10,1,1,0,0,14492,6.4,16087,176,48,-2828,-1814,17.6,1449.2,16,3,0,7,5,4,1,0,1,0,17320,6.6,17901,217,54,2828,1814,21.7,1732
4502539772,0,14,2,1,3,8,6,0,0,0,0,15193,6.8,17054,232,57,-1810,-2661,23.2,1519.3,16,0,0,8,3,2,1,1,0,0,17003,7,19715,235,65,1810,2661,23.5,1700.3
4527107365,0,15,1,1,4,8,0,0,0,0,0,13362,6.4,15531,155,34,-4968,-4165,15.5,1336.2,12,3,0,8,4,4,1,1,0,0,18330,7.2,19696,240,67,4968,4165,24,1833
4525339326,1,14,2,1,1,3,1,1,1,0,0,14832,7,17330,228,60,-196,-282,22.8,1483.2,18,2,0,3,1,4,0,0,0,0,15028,7,17612,226,48,196,282,22.6,1502.8
4510322898,1,16,4,1,9,2,12,1,1,0,0,17664,7,17554,221,46,2946,1011,22.1,1766.4,13,5,0,2,9,4,0,0,0,0,14718,6.6,16543,236,46,-2946,-1011,23.6,1471.8
4511761586,1,45,5,0,6,7,8,1,1,0,0,17046,7.4,19783,217,67,307,2085,21.7,1704.6,16,7,1,7,6,7,0,0,0,0,16739,7,17698,256,40,-307,-2085,25.6,1673.9
4519356539,0,38,4,1,3,0,3,0,0,0,0,15984,6.8,18306,261,49,1916,632,26.1,1598.4,16,0,0,0,3,0,0,0,0,0,14068,6.8,17674,224,72,-1916,-632,22.4,1406.8
4523788727,1,13,1,1,12,9,18,0,0,0,0,18748,6.8,17354,195,45,1212,77,19.5,1874.8,13,1,0,9,12,8,1,1,0,0,17536,7,17277,193,52,-1212,-77,19.3,1753.6
4503411816,1,17,3,1,5,1,6,0,0,0,0,16733,7.2,19698,231,62,1901,1126,23.1,1673.3,14,4,0,1,5,1,2,1,1,0,14832,7,18572,239,68,-1901,-1126,23.9,1483.2
4526812997,0,58,2,0,6,12,12,1,1,0,0,15417,6.4,15374,154,51,-4032,-2866,15.4,1541.7,35,4,1,12,6,11,0,0,0,0,19449,7,18240,232,52,4032,2866,23.2,1944.9
4527587697,0,18,3,1,10,6,7,1,1,0,0,18302,7.2,18149,215,40,2617,1172,21.5,1830.2,15,4,0,6,10,4,1,0,1,0,15685,6.8,16977,178,63,-2617,-1172,17.8,1568.5
4526761574,1,79,2,0,3,3,2,0,0,0,0,15471,6.8,18349,219,51,-251,560,21.9,1547.1,14,2,1,3,3,7,0,0,0,0,15722,7,17789,255,52,251,-560,25.5,1572.2
4513988125,1,36,7,1,6,4,11,1,1,0,0,16612,6.8,17712,218,56,1094,287,21.8,1661.2,18,2,0,4,6,4,0,0,0,0,15518,6.8,17425,221,60,-1094,-287,22.1,1551.8
4516990759,1,57,5,1,6,4,3,0,0,0,0,16601,7,18618,242,52,1235,1010,24.2,1660.1,15,3,0,4,6,5,0,0,0,0,15366,6.8,17608,201,44,-1235,-1010,20.1,1536.6
4526157711,1,52,1,1,9,1,13,2,1,1,0,18159,6.6,16870,217,59,5302,3045,21.7,1815.9,13,0,0,1,9,2,0,0,0,0,12857,6,13825,147,48,-5302,-3045,14.7,1285.7
4526376483,0,17,2,0,5,7,9,0,0,0,0,14690,6.4,15168,188,40,-5426,-3115,18.8,1469,14,0,1,7,5,9,1,1,0,2,20116,7,18283,245,43,5426,3115,24.5,2011.6
4502939535,1,15,2,1,9,3,9,0,0,0,0,16963,7,18341,245,37,2609,681,24.5,1696.3,17,3,0,3,9,2,1,1,0,0,14354,7,17660,209,52,-2609,-681,20.9,1435.4
4499945956,0,12,6,1,5,8,4,0,0,0,0,16116,6.8,16953,233,43,-89,-953,23.3,1611.6,16,2,0,8,5,3,1,1,0,0,16205,6.8,17906,213,52,89,953,21.3,1620.5
4521141561,0,19,4,0,5,12,5,0,0,0,0,15341,6.4,15896,188,32,-3588,-1795,18.8,1534.1,14,6,1,12,5,13,1,1,0,0,18929,6.6,17691,230,44,3588,1795,23,1892.9
4502988804,0,14,5,0,2,8,2,0,0,0,0,14177,6.4,15427,196,54,-2115,-2872,19.6,1417.7,18,2,1,8,2,18,1,1,0,0,16292,7,18299,200,43,2115,2872,20,1629.2
4526305174,0,17,4,1,7,4,11,0,0,0,0,17308,7.2,18538,213,44,1589,-197,21.3,1730.8,16,3,0,4,7,1,2,1,1,0,15719,7,18735,232,70,-1589,197,23.2,1571.9
4506241300,0,24,1,1,4,5,5,0,0,0,0,15758,6.4,16906,211,50,628,-558,21.1,1575.8,52,1,0,5,4,9,1,1,0,0,15130,6.8,17464,205,37,-628,558,20.5,1513
4511072996,0,13,1,1,8,10,14,1,1,0,0,17275,6.8,16684,204,55,-604,-1254,20.4,1727.5,37,5,0,10,8,16,0,0,0,0,17879,7,17938,186,52,604,1254,18.6,1787.9
4509031908,0,11,1,1,7,10,4,1,1,0,0,16505,6.6,17778,206,39,-1861,-1195,20.6,1650.5,13,0,0,10,7,11,0,0,0,0,18366,7,18973,221,44,1861,1195,22.1,1836.6
4521833951,0,16,4,1,8,3,13,0,0,0,0,18093,7.2,18506,238,51,2774,1134,23.8,1809.3,40,6,0,3,8,3,1,1,0,0,15319,6.8,17372,230,47,-2774,-1134,23,1531.9
4499814815,0,11,2,0,7,9,5,0,0,0,0,15939,6.6,16482,205,31,-1323,-1025,20.5,1593.9,15,0,1,9,7,6,0,0,0,0,17262,6.8,17507,167,34,1323,1025,16.7,1726.2
4525831226,0,59,1,0,0,1,0,1,1,0,0,14457,7,18824,230,72,-832,541,23,1445.7,20,0,1,1,0,1,0,0,0,0,15289,7,18283,267,63,832,-541,26.7,1528.9
4475185229,1,39,0,0,11,5,12,1,0,1,2,20920,7.2,19263,243,36,5418,3077,24.3,2092,12,0,1,5,11,8,0,0,0,0,15502,6.8,16186,173,47,-5418,-3077,17.3,1550.2
4500080276,1,19,1,1,7,0,8,0,0,0,0,16688,7.2,19162,233,60,3060,2469,23.3,1668.8,32,0,0,0,7,0,1,1,0,0,13628,6.8,16693,222,57,-3060,-2469,22.2,1362.8
4507744435,0,14,1,0,2,7,1,0,0,0,0,14873,6.8,17781,205,72,-2304,31,20.5,1487.3,15,1,1,7,2,9,1,1,0,0,17177,7,17750,238,44,2304,-31,23.8,1717.7
4522320216,0,21,0,0,4,7,4,0,0,0,0,15259,7,17666,214,63,-1396,-92,21.4,1525.9,14,6,1,7,4,7,1,1,0,0,16655,6.6,17758,250,48,1396,92,25,1665.5
4506553264,1,14,0,1,10,3,9,1,1,0,0,18096,7.2,19349,242,46,3738,4262,24.2,1809.6,11,4,0,3,10,4,0,0,0,0,14358,6.4,15087,198,47,-3738,-4262,19.8,1435.8
4514417841,1,15,2,1,5,3,5,1,0,1,0,16153,6.8,17913,227,35,1184,-80,22.7,1615.3,42,3,0,3,5,3,1,1,0,0,14969,7,17993,208,70,-1184,80,20.8,1496.9
4511678140,1,16,2,1,7,9,10,1,0,1,1,19036,7.2,19444,248,60,2346,751,24.8,1903.6,37,1,0,9,7,14,1,1,0,0,16690,7.4,18693,197,53,-2346,-751,19.7,1669
4527646038,0,16,5,0,10,11,12,0,0,0,0,17788,6.8,17829,159,59,-275,-739,15.9,1778.8,20,4,1,11,10,7,0,0,0,0,18063,7,18568,212,55,275,739,21.2,1806.3
4516268505,1,42,2,1,8,3,6,0,0,0,0,16532,7.2,18420,229,40,1558,785,22.9,1653.2,34,2,0,3,8,2,1,0,1,0,14974,7,17635,206,56,-1558,-785,20.6,1497.4
4526987414,0,27,2,1,3,6,4,0,0,0,0,15742,7,17970,214,64,-750,-276,21.4,1574.2,18,2,0,6,3,6,1,1,0,0,16492,7.2,18246,232,52,750,276,23.2,1649.2
4526906717,1,105,6,1,4,3,0,0,0,0,0,15960,7.4,18912,253,60,1479,2350,25.3,1596,15,3,0,3,4,3,0,0,0,0,14481,6.4,16562,228,40,-1479,-2350,22.8,1448.1
4525315485,0,15,0,0,6,8,6,0,0,0,0,16132,6.8,18331,199,57,-1850,-1016,19.9,1613.2,16,2,1,8,6,9,1,1,0,0,17982,7.4,19347,243,54,1850,1016,24.3,1798.2
4519712655,0,73,0,1,9,8,10,0,0,0,0,17350,7.2,18836,202,45,620,874,20.2,1735,16,2,0,8,9,8,0,0,0,0,16730,6.6,17962,211,49,-620,-874,21.1,1673
4524754524,0,15,2,0,3,8,2,0,0,0,0,13875,6.6,16394,209,36,-3866,-1987,20.9,1387.5,23,3,1,8,3,10,1,1,0,0,17741,7.2,18381,227,47,3866,1987,22.7,1774.1
4522030672,1,17,3,0,1,1,1,1,0,1,0,14969,6.8,17547,252,48,1089,33,25.2,1496.9,49,2,1,1,1,0,0,0,0,0,13880,6.8,17514,212,47,-1089,-33,21.2,1388
4526010280,1,36,3,0,9,7,6,2,1,1,0,17195,7.2,18590,178,75,827,1271,17.8,1719.5,17,1,1,7,9,7,0,0,0,0,16368,6.8,17319,201,46,-827,-1271,20.1,1636.8
4506537337,0,16,4,1,4,5,3,0,0,0,0,15347,7,17655,234,46,-1374,-1041,23.4,1534.7,22,0,0,5,4,7,2,1,1,0,16721,6.8,18696,238,57,1374,1041,23.8,1672.1
4519118449,1,15,2,0,10,3,13,1,1,0,0,18290,7.6,20250,248,44,3943,4243,24.8,1829,15,2,1,3,10,4,0,0,0,0,14347,6.4,16007,200,51,-3943,-4243,20,1434.7
4525208394,0,17,3,0,5,3,5,1,0,1,0,16176,7.2,18728,221,60,543,1065,22.1,1617.6,10,4,1,3,5,4,0,0,0,0,15633,6.8,17663,257,51,-543,-1065,25.7,1563.3
4526069179,0,15,2,1,6,6,7,1,1,0,0,16148,6.8,15943,200,45,-1106,-1434,20,1614.8,15,2,0,6,6,9,1,0,1,0,17254,6.6,17377,216,70,1106,1434,21.6,1725.4
4524419928,1,14,1,1,3,4,4,2,1,1,0,15612,7,18702,214,72,-1011,-309,21.4,1561.2,18,2,0,4,3,6,0,0,0,0,16623,7.2,19011,239,65,1011,309,23.9,1662.3
4516204235,1,18,2,0,5,4,7,1,0,1,0,16104,7,17890,231,48,1039,589,23.1,1610.4,16,5,1,4,5,3,1,1,0,0,15065,6.8,17301,205,47,-1039,-589,20.5,1506.5
4527544639,0,50,1,0,8,9,8,0,0,0,0,15372,6.8,16833,161,40,-3616,-3352,16.1,1537.2,12,2,1,9,8,4,1,1,0,0,18988,7.6,20185,248,64,3616,3352,24.8,1898.8
4510853790,0,16,6,0,4,4,5,0,0,0,0,15694,6.8,18453,242,59,217,709,24.2,1569.4,17,3,1,4,4,4,1,1,0,0,15477,7,17744,214,60,-217,-709,21.4,1547.7
4527220222,1,18,5,0,9,7,11,1,0,1,0,17578,7.2,18250,209,43,1641,1439,20.9,1757.8,18,4,1,7,9,10,0,0,0,0,15937,7,16811,175,56,-1641,-1439,17.5,1593.7
4526484364,1,19,2,1,10,5,11,1,1,0,0,18436,7,18039,209,47,1990,-86,20.9,1843.6,16,4,0,5,10,4,1,0,1,0,16446,6.8,18125,226,48,-1990,86,22.6,1644.6
4520786443,0,13,1,1,7,4,7,1,0,1,0,16620,7.2,18824,211,48,273,255,21.1,1662,13,2,0,4,7,7,1,1,0,0,16347,7,18569,226,67,-273,-255,22.6,1634.7
4509008728,0,18,3,1,5,2,4,2,1,1,0,16419,7,19317,248,57,1994,2643,24.8,1641.9,16,5,0,2,5,3,0,0,0,0,14425,6.6,16674,238,36,-1994,-2643,23.8,1442.5
4509162427,1,34,3,0,5,5,5,0,0,0,0,16384,7.4,19826,229,61,759,2511,22.9,1638.4,17,2,1,5,5,7,1,1,0,0,15625,6.6,17315,205,55,-759,-2511,20.5,1562.5
4524227003,0,16,8,0,3,8,3,1,0,1,0,15330,7,18294,230,57,-2105,-1066,23,1533,24,5,1,8,3,8,1,1,0,0,17435,7.2,19360,225,60,2105,1066,22.5,1743.5
4521974813,1,47,3,1,10,1,18,2,1,1,0,19008,7.2,19021,239,68,4319,2388,23.9,1900.8,13,3,0,1,10,2,0,0,0,0,14689,6.6,16633,240,56,-4319,-2388,24,1468.9
4515451687,0,62,2,0,5,2,7,0,0,0,0,16238,7,18854,260,36,428,374,26,1623.8,82,2,1,2,5,1,1,0,1,0,15810,7.2,18480,232,80,-428,-374,23.2,1581
4502573246,1,17,1,0,5,4,7,0,0,0,0,16094,6.8,17711,219,41,956,1998,21.9,1609.4,15,1,1,4,5,4,0,0,0,0,15138,6.6,15713,183,36,-956,-1998,18.3,1513.8
4524060620,0,15,0,0,5,14,5,0,0,0,0,15099,6.8,17734,156,45,-5206,-1622,15.6,1509.9,13,2,1,14,5,8,0,0,0,1,20305,7,19356,226,39,5206,1622,22.6,2030.5
4521025681,0,19,3,0,2,10,0,0,0,0,0,14143,6.6,16647,183,55,-5891,-3716,18.3,1414.3,12,2,1,10,2,7,2,1,1,1,20034,7.4,20363,264,48,5891,3716,26.4,2003.4
4523694743,0,106,4,0,3,10,4,1,1,0,0,14385,6.4,15780,195,42,-4413,-3109,19.5,1438.5,16,1,1,10,3,12,1,0,1,0,18798,7,18889,234,41,4413,3109,23.4,1879.8
4526803305,0,54,2,0,3,4,6,0,0,0,0,14725,6.8,17291,204,43,-1680,-1155,20.4,1472.5,21,3,1,4,3,3,2,1,1,0,16405,7.4,18446,258,56,1680,1155,25.8,1640.5
4509982374,0,19,4,0,6,5,7,0,0,0,0,16543,7,18558,245,48,192,-656,24.5,1654.3,18,4,1,5,6,7,1,1,0,0,16351,7.2,19214,245,56,-192,656,24.5,1635.1
4508518310,0,16,2,0,2,3,4,0,0,0,0,14505,6.8,18139,230,51,-1183,-182,23,1450.5,42,3,1,3,2,4,1,1,0,0,15688,7,18321,253,48,1183,182,25.3,1568.8
4503986448,0,18,4,1,7,4,5,0,0,0,0,16681,7,18270,265,39,1403,389,26.5,1668.1,44,4,0,4,7,5,0,0,0,0,15278,7,17881,224,35,-1403,-389,22.4,1527.8
4520653758,0,14,1,1,6,7,11,0,0,0,0,15844,6.8,16801,197,47,-151,-895,19.7,1584.4,17,0,0,7,6,5,2,1,1,0,15995,6.8,17696,205,60,151,895,20.5,1599.5
4527207692,1,18,5,1,5,5,7,0,0,0,0,15843,7,17530,233,35,380,-245,23.3,1584.3,17,7,0,5,5,5,1,1,0,0,15463,7,17775,221,51,-380,245,22.1,1546.3
4500460530,1,23,1,1,9,2,12,1,1,0,0,17913,7.4,19102,218,53,3453,1775,21.8,1791.3,10,0,0,2,9,2,0,0,0,0,14460,6.8,17327,215,57,-3453,-1775,21.5,1446
4512191521,0,14,1,0,3,6,4,0,0,0,0,15057,6.8,17267,218,64,-3443,-1347,21.8,1505.7,16,3,1,6,3,10,1,1,0,1,18500,7.2,18614,219,68,3443,1347,21.9,1850
4505307600,1,19,6,1,5,9,5,0,0,0,0,14630,6.6,16527,177,28,-2167,-2045,17.7,1463,18,4,0,9,5,10,1,1,0,0,16797,7,18572,214,41,2167,2045,21.4,1679.7
4526123124,1,16,20,1,4,4,4,0,0,0,0,16156,6.8,17794,260,46,152,-722,26,1615.6,49,5,0,4,4,3,0,0,0,0,16004,7,18516,249,55,-152,722,24.9,1600.4
4511008520,0,17,1,0,2,5,1,1,1,0,0,13352,6.6,16455,188,44,-3059,-2718,18.8,1335.2,12,1,1,5,2,3,1,0,1,0,16411,7,19173,252,48,3059,2718,25.2,1641.1
4526787106,0,37,2,1,4,5,4,1,1,0,0,16042,7,17865,240,68,-236,711,24,1604.2,16,2,0,5,4,8,0,0,0,0,16278,6.8,17154,241,44,236,-711,24.1,1627.8
4526234788,1,45,2,0,5,8,5,1,0,1,0,15420,6.8,16996,176,50,-2178,-1407,17.6,1542,14,2,1,8,5,7,1,1,0,0,17598,7,18403,219,34,2178,1407,21.9,1759.8
4516306111,0,15,2,0,2,5,0,0,0,0,0,15080,6.8,17979,262,56,-1267,427,26.2,1508,13,5,1,5,2,6,2,1,1,0,16347,7,17552,255,48,1267,-427,25.5,1634.7
4522338858,1,52,3,0,4,7,5,1,1,0,0,15766,7,18750,232,60,-1035,582,23.2,1576.6,18,4,1,7,4,7,0,0,0,0,16801,7,18168,202,55,1035,-582,20.2,1680.1
4502334465,1,18,4,1,11,8,16,1,0,1,1,20639,7.2,18457,207,61,4639,3197,20.7,2063.9,15,3,0,8,11,10,1,1,0,0,16000,6.2,15260,159,55,-4639,-3197,15.9,1600
4494986980,0,14,3,0,0,9,0,0,0,0,0,13345,6.6,15982,230,42,-5508,-3648,23,1334.5,38,3,1,9,0,10,1,1,0,1,18853,7.2,19630,235,57,5508,3648,23.5,1885.3
4527522353,1,17,7,0,10,7,9,1,1,0,0,17712,7,19043,207,42,2370,3795,20.7,1771.2,18,3,1,7,10,6,0,0,0,0,15342,6.4,15248,186,38,-2370,-3795,18.6,1534.2
4525983160,1,11,4,1,11,4,13,1,1,0,0,18866,7,18926,225,41,3992,2506,22.5,1886.6,19,1,0,4,11,3,0,0,0,0,14874,6.4,16420,189,45,-3992,-2506,18.9,1487.4
4516712526,1,20,2,1,11,4,11,1,1,0,0,19035,7.4,19997,232,43,2739,1170,23.2,1903.5,16,2,0,4,11,5,1,0,1,0,16296,7.2,18827,268,44,-2739,-1170,26.8,1629.6
4527289282,1,13,4,0,3,9,3,0,0,0,0,15292,6.8,17170,223,55,-2513,-2247,22.3,1529.2,14,3,1,9,3,8,1,1,0,0,17805,7.2,19417,231,44,2513,2247,23.1,1780.5
4502535933,1,76,1,1,1,1,1,0,0,0,0,15082,6.8,17854,239,51,1389,894,23.9,1508.2,15,2,0,1,1,0,1,1,0,0,13693,6.4,16960,209,56,-1389,-894,20.9,1369.3
4507594036,1,14,1,0,6,8,7,0,0,0,0,15818,6.6,16894,162,53,-1492,-1925,16.2,1581.8,13,2,1,8,6,5,1,1,0,0,17310,7.2,18819,214,56,1492,1925,21.4,1731
4515910414,0,15,3,1,11,10,10,1,0,1,0,18145,7.2,18705,211,40,-139,-652,21.1,1814.5,14,3,0,10,11,8,1,1,0,0,18284,7.2,19357,236,50,139,652,23.6,1828.4
4525790014,1,11,3,1,5,3,2,0,0,0,0,15934,7,18258,251,52,943,505,25.1,1593.4,16,0,0,3,5,2,1,1,0,0,14991,7,17753,231,56,-943,-505,23.1,1499.1
4509319311,1,18,2,1,8,5,12,1,1,0,0,17846,7,18097,192,67,2425,824,19.2,1784.6,15,1,0,5,8,4,1,0,1,0,15421,6.8,17273,215,48,-2425,-824,21.5,1542.1
4525851788,1,12,2,1,6,5,9,1,0,1,0,17025,6.8,17699,207,56,1128,-45,20.7,1702.5,17,1,0,5,6,4,1,1,0,0,15897,7,17744,226,52,-1128,45,22.6,1589.7
4500869291,0,20,3,0,11,8,9,2,1,1,0,17598,7.2,18935,225,52,1380,1402,22.5,1759.8,15,1,1,8,11,8,0,0,0,0,16218,6.8,17533,192,44,-1380,-1402,19.2,1621.8
4515205200,0,14,4,1,4,3,2,1,0,1,0,16220,7,18251,239,54,688,415,23.9,1622,22,1,0,3,4,4,1,1,0,0,15532,7,17836,221,57,-688,-415,22.1,1553.2
4507437151,0,13,4,0,11,6,13,1,1,0,0,18395,6.6,16701,206,31,2933,1905,20.6,1839.5,12,1,1,6,11,6,0,0,0,0,15462,6.2,14796,167,39,-2933,-1905,16.7,1546.2
4509649121,0,36,2,0,6,12,4,1,0,1,0,15727,6.2,15909,171,49,-2467,-1494,17.1,1572.7,15,3,1,12,6,13,0,0,0,0,18194,7,17403,202,35,2467,1494,20.2,1819.4
4511683364,1,19,5,0,4,3,3,0,0,0,0,15832,7.2,18431,257,52,755,436,25.7,1583.2,17,4,1,3,4,4,2,1,1,0,15077,7,17995,217,60,-755,-436,21.7,1507.7
4524119242,1,19,0,1,10,2,12,1,1,0,0,18549,7.2,19419,203,63,4378,3157,20.3,1854.9,9,6,0,2,10,2,0,0,0,0,14171,6.6,16262,214,44,-4378,-3157,21.4,1417.1
4521081622,0,14,2,1,8,10,5,1,1,0,0,16589,6.8,17707,221,44,-1302,-90,22.1,1658.9,18,6,0,10,8,14,0,0,0,0,17891,7,17797,207,50,1302,90,20.7,1789.1
4513902880,1,11,1,1,5,2,4,0,0,0,0,14945,6.8,17524,168,48,-145,850,16.8,1494.5,16,3,0,2,5,2,1,1,0,0,15090,6.6,16674,233,48,145,-850,23.3,1509
4506650887,1,14,8,1,9,4,6,1,0,1,1,19279,7.6,19873,230,69,4305,3750,23,1927.9,203,1,0,4,9,4,1,1,0,0,14974,6.4,16123,182,42,-4305,-3750,18.2,1497.4
4525849637,1,16,1,0,5,11,5,0,0,0,0,15871,6.6,16394,200,56,-3162,-23,20,1587.1,15,8,1,11,5,15,0,0,0,1,19033,6.4,16417,195,36,3162,23,19.5,1903.3
4505985909,1,12,2,0,8,9,7,2,1,1,1,18790,7.2,18604,224,48,1726,-196,22.4,1879,72,4,1,9,8,13,0,0,0,0,17064,7.2,18800,195,51,-1726,196,19.5,1706.4
4508832149,0,18,4,1,9,7,8,1,0,1,0,16616,7,17642,182,39,350,689,18.2,1661.6,19,5,0,7,9,5,1,1,0,0,16266,6.8,16953,206,52,-350,-689,20.6,1626.6
4521837052,1,19,1,0,5,9,7,0,0,0,0,15701,6.8,16610,186,60,-2760,-2274,18.6,1570.1,16,2,1,9,5,9,1,1,0,0,18461,7.2,18884,247,50,2760,2274,24.7,1846.1
4526108051,0,18,1,0,9,7,9,0,0,0,0,17556,7.2,18967,214,59,805,1723,21.4,1755.6,12,3,1,7,9,12,1,1,0,0,16751,6.8,17244,230,36,-805,-1723,23,1675.1
4511255731,0,12,4,0,1,8,1,1,1,0,0,13591,6.6,16284,201,56,-3754,-2371,20.1,1359.1,13,4,1,8,1,6,0,0,0,0,17345,7.2,18655,256,56,3754,2371,25.6,1734.5
4526616225,1,35,1,1,10,4,8,1,1,0,0,17637,7,18484,198,64,2216,949,19.8,1763.7,15,1,0,4,10,2,1,0,1,0,15421,6.8,17535,236,39,-2216,-949,23.6,1542.1
4526030485,1,17,2,1,7,2,4,0,0,0,0,17047,7,19573,224,54,3135,1888,22.4,1704.7,15,4,0,2,7,1,1,1,0,0,13912,6.8,17685,201,50,-3135,-1888,20.1,1391.2
4506841392,0,16,3,0,9,5,14,2,1,1,0,17821,7.2,18702,215,46,1855,1520,21.5,1782.1,16,0,1,5,9,4,0,0,0,0,15966,6.6,17182,233,57,-1855,-1520,23.3,1596.6
4518702917,0,25,3,1,5,4,7,0,0,0,0,15694,7,18079,209,53,-451,591,20.9,1569.4,24,4,0,4,5,5,1,1,0,0,16145,7,17488,241,63,451,-591,24.1,1614.5
4525303042,0,17,0,1,8,9,8,0,0,0,0,16640,6.6,16726,222,43,-1939,-2911,22.2,1664,14,1,0,9,8,15,2,1,1,0,18579,7.4,19637,233,56,1939,2911,23.3,1857.9
4521047659,1,19,2,0,4,3,4,1,1,0,0,16235,7,18651,260,58,584,370,26,1623.5,16,2,1,3,4,7,0,0,0,0,15651,7,18281,221,68,-584,-370,22.1,1565.1
4508648628,0,30,1,0,3,9,2,1,0,1,0,14423,7.2,17518,188,59,-2911,-286,18.8,1442.3,12,1,1,9,3,12,0,0,0,0,17334,6.8,17804,201,38,2911,286,20.1,1733.4
4517695714,0,18,8,0,6,6,4,0,0,0,0,15911,6.6,17205,224,36,-194,-1106,22.4,1591.1,17,4,1,6,6,7,0,0,0,0,16105,7.2,18311,193,48,194,1106,19.3,1610.5
4516988752,0,13,1,0,3,9,3,0,0,0,0,14232,6.8,17038,186,56,-3082,-646,18.6,1423.2,15,3,1,9,3,14,1,1,0,0,17314,6.8,17684,208,48,3082,646,20.8,1731.4
4526878026,0,19,3,1,5,8,2,0,0,0,0,15429,6.6,16825,227,48,-1480,-1366,22.7,1542.9,53,1,0,8,5,10,0,0,0,0,16909,6.8,18191,218,42,1480,1366,21.8,1690.9
4509977321,0,12,4,0,2,5,1,0,0,0,0,14349,7,17864,199,62,-2289,-277,19.9,1434.9,20,1,1,5,2,4,1,1,0,0,16638,7.2,18141,246,57,2289,277,24.6,1663.8
4514142967,1,18,2,0,10,12,15,1,1,0,0,17877,6.8,17302,186,43,-920,-1562,18.6,1787.7,19,3,1,12,10,9,1,0,1,0,18797,7.2,18864,231,40,920,1562,23.1,1879.7
4492831778,1,12,3,0,8,10,8,0,0,0,0,15968,6.4,15868,145,42,-1912,-19,14.5,1596.8,15,3,1,10,8,13,1,1,0,0,17880,6.6,15887,191,33,1912,19,19.1,1788
4516967863,1,16,2,1,7,8,5,2,1,1,1,17931,7,18404,210,65,-546,-104,21,1793.1,12,4,0,8,7,13,0,0,0,0,18477,7,18508,217,50,546,104,21.7,1847.7
4510156433,0,15,3,0,9,7,10,0,0,0,0,17082,7.2,18101,223,36,188,-498,22.3,1708.2,15,1,1,7,9,11,1,1,0,0,16894,7,18599,215,72,-188,498,21.5,1689.4
4509929305,0,15,5,0,7,8,6,1,1,0,0,17147,7,18525,205,52,-142,-1193,20.5,1714.7,15,5,1,8,7,2,1,0,1,0,17289,7.4,19718,242,59,142,1193,24.2,1728.9
4524922802,1,16,5,1,12,4,14,0,0,0,0,18338,7,18468,211,43,3054,2510,21.1,1833.8,18,0,0,4,12,2,1,1,0,0,15284,6.6,15958,190,61,-3054,-2510,19,1528.4
4521352083,0,31,4,0,4,9,3,1,1,0,0,15367,6.6,17109,214,54,-2572,-2642,21.4,1536.7,45,0,1,9,4,12,1,0,1,0,17939,7,19751,198,70,2572,2642,19.8,1793.9
4527650807,1,47,3,1,2,4,3,1,1,0,0,14408,6.6,16534,212,49,-1147,-1842,21.2,1440.8,15,2,0,4,2,4,0,0,0,0,15555,6.8,18376,218,52,1147,1842,21.8,1555.5
4511176249,1,49,1,1,5,4,6,0,0,0,0,14991,6.8,17977,193,43,-274,-406,19.3,1499.1,17,3,0,4,5,3,1,1,0,0,15265,7,18383,217,56,274,406,21.7,1526.5
4518413320,1,37,6,0,5,1,6,1,0,1,0,16144,7,17907,226,65,2237,1009,22.6,1614.4,33,2,1,1,5,1,0,0,0,0,13907,6.8,16898,226,53,-2237,-1009,22.6,1390.7
4526208806,0,16,1,1,6,8,6,0,0,0,0,15186,6.8,16381,204,24,-2666,-1972,20.4,1518.6,38,4,0,8,6,14,1,1,0,0,17852,7,18353,218,57,2666,1972,21.8,1785.2
4517672775,1,15,1,1,7,3,11,1,1,0,0,17072,7,19087,227,52,1782,1234,22.7,1707.2,11,3,0,3,7,1,0,0,0,0,15290,7,17853,212,61,-1782,-1234,21.2,1529
4513061726,0,14,3,1,2,6,2,1,1,0,0,15381,6.6,16972,249,52,-2545,-1960,24.9,1538.1,15,4,0,6,2,6,1,0,1,1,17926,7,18932,243,56,2545,1960,24.3,1792.6
4515259819,1,137,1,0,0,3,0,1,1,0,0,13610,6.6,16594,199,46,-1817,-1854,19.9,1361,18,2,1,3,0,1,0,0,0,0,15427,7,18448,238,53,1817,1854,23.8,1542.7
4515471946,1,16,7,1,7,4,9,0,0,0,0,16535,7,17582,230,33,443,-1176,23,1653.5,21,2,0,4,7,3,0,0,0,0,16092,7,18758,216,64,-443,1176,21.6,1609.2
4526301397,0,10,1,0,3,11,4,0,0,0,0,15145,6.6,16768,200,32,-3472,-3059,20,1514.5,102,0,1,11,3,6,1,0,1,0,18617,7.4,19827,227,63,3472,3059,22.7,1861.7
4506659179,0,17,2,0,8,8,4,0,0,0,0,15686,6.8,17245,195,35,-2594,-1150,19.5,1568.6,15,2,1,8,8,9,0,0,0,0,18280,7,18395,236,60,2594,1150,23.6,1828
4507080672,1,18,2,1,10,5,14,1,1,0,0,17379,7,18458,200,52,1138,-7,20,1737.9,17,2,0,5,10,3,0,0,0,0,16241,7,18465,246,44,-1138,7,24.6,1624.1
4524768975,0,15,2,1,10,15,12,0,0,0,0,18051,6.8,17921,201,41,-2224,-2008,20.1,1805.1,15,3,0,15,10,13,1,1,0,0,20275,7.4,19929,226,48,2224,2008,22.6,2027.5
4506887349,1,14,7,0,3,2,3,1,1,0,0,16075,7.2,19032,251,63,597,559,25.1,1607.5,15,4,1,2,3,3,0,0,0,0,15478,7,18473,244,44,-597,-559,24.4,1547.8
4522491015,1,38,4,1,3,3,6,2,1,1,0,14854,7,16846,212,44,-630,-865,21.2,1485.4,17,1,0,3,3,2,0,0,0,0,15484,7,17711,203,68,630,865,20.3,1548.4
4514601877,1,41,5,1,4,2,5,1,1,0,0,15770,7,17426,229,60,669,-483,22.9,1577,20,2,0,2,4,1,0,0,0,0,15101,7,17909,261,43,-669,483,26.1,1510.1
4497670644,1,38,2,0,7,8,8,0,0,0,0,16308,7.2,17911,199,48,-1464,-1575,19.9,1630.8,15,3,1,8,7,3,0,0,0,0,17772,7.4,19486,250,48,1464,1575,25,1777.2
4525597127,0,18,2,0,3,3,4,1,1,0,0,15008,7,18344,211,56,-37,1144,21.1,1500.8,17,3,1,3,3,3,0,0,0,0,15045,6.8,17200,221,47,37,-1144,22.1,1504.5
4518443170,1,18,0,0,5,5,5,0,0,0,0,15238,6.8,17288,184,60,-719,825,18.4,1523.8,16,2,1,5,5,4,0,0,0,0,15957,6.8,16463,211,44,719,-825,21.1,1595.7
4514156871,1,12,2,1,4,4,2,2,1,1,0,15534,7,18339,223,64,-483,-442,22.3,1553.4,14,2,0,4,4,5,0,0,0,0,16017,7.2,18781,266,52,483,442,26.6,1601.7
4510890954,0,40,3,1,8,8,6,1,1,0,0,16707,6.6,17154,217,44,-164,343,21.7,1670.7,13,13,0,8,8,12,0,0,0,0,16871,6.8,16811,174,49,164,-343,17.4,1687.1
4511901984,0,19,3,0,3,4,5,0,0,0,0,17200,7,18695,237,57,1266,612,23.7,1720,14,1,1,4,3,3,1,1,0,0,15934,7,18083,239,55,-1266,-612,23.9,1593.4
4527144840,0,12,3,0,3,11,3,0,0,0,0,14830,6.6,17313,221,48,-4299,-3010,22.1,1483,34,3,1,11,3,17,0,0,0,0,19129,7.4,20323,228,64,4299,3010,22.8,1912.9
4527075241,1,14,3,1,6,6,7,1,1,0,0,16620,6.8,16713,212,52,1156,168,21.2,1662,18,3,0,6,6,6,1,0,1,0,15464,6.6,16545,200,39,-1156,-168,20,1546.4
4508196606,1,17,2,1,9,2,12,2,1,1,0,17611,7,18390,232,45,3878,3016,23.2,1761.1,18,2,0,2,9,4,0,0,0,0,13733,6.4,15374,205,44,-3878,-3016,20.5,1373.3
4525941408,1,16,1,0,9,7,12,1,1,0,0,17908,7,17505,220,55,1717,775,22,1790.8,10,0,1,7,9,9,1,0,1,0,16191,6.6,16730,212,35,-1717,-775,21.2,1619.1
4511628511,1,15,1,1,7,5,9,1,1,0,0,17791,7,19243,244,71,2037,2483,24.4,1779.1,14,4,0,5,7,5,0,0,0,0,15754,6.6,16760,209,36,-2037,-2483,20.9,1575.4
4514796338,0,16,1,0,2,6,3,0,0,0,0,15509,7,18064,235,58,-1098,-966,23.5,1550.9,138,3,1,6,2,4,2,1,1,0,16607,7.2,19030,204,68,1098,966,20.4,1660.7
4505630754,1,18,2,1,6,5,4,0,0,0,0,16304,6.8,17893,209,50,-794,-951,20.9,1630.4,13,3,0,5,6,3,0,0,0,0,17098,7.2,18844,220,73,794,951,22,1709.8
4526523004,0,14,5,1,7,3,14,1,1,0,0,16594,7,18266,217,51,611,290,21.7,1659.4,18,1,0,3,7,1,0,0,0,0,15983,6.8,17976,239,60,-611,-290,23.9,1598.3
4518722458,0,27,4,0,4,7,3,0,0,0,0,14732,6.6,16332,186,47,-2749,-3335,18.6,1473.2,15,3,1,7,4,6,1,1,0,0,17481,7.6,19667,222,76,2749,3335,22.2,1748.1
4514235759,1,15,0,0,9,8,5,1,0,1,0,17149,6.8,17767,211,35,-417,-1028,21.1,1714.9,39,4,1,8,9,6,1,1,0,0,17566,7,18795,215,61,417,1028,21.5,1756.6
4504764958,1,17,2,1,7,1,9,0,0,0,0,18408,7.4,20063,250,60,4119,2320,25,1840.8,15,1,0,1,7,1,2,1,1,0,14289,6.8,17743,234,51,-4119,-2320,23.4,1428.9
4524396486,0,14,2,0,0,5,0,0,0,0,0,14211,6.6,17270,232,59,-3051,-2114,23.2,1421.1,21,6,1,5,0,3,2,1,1,1,17262,7.2,19384,250,55,3051,2114,25,1726.2
4520893771,1,15,16,1,3,2,4,2,1,1,0,15698,7,18088,253,56,-451,-1374,25.3,1569.8,43,5,0,2,3,1,0,0,0,0,16149,7.2,19462,255,75,451,1374,25.5,1614.9
4524792382,0,41,1,1,7,8,8,1,1,0,0,15956,6.6,17062,200,44,-916,-1466,20,1595.6,12,1,0,8,7,6,0,0,0,0,16872,7.2,18528,204,52,916,1466,20.4,1687.2
4518264766,1,16,5,1,12,1,24,1,1,0,0,20289,7.2,20144,245,48,7039,4860,24.5,2028.9,54,1,0,1,12,1,0,0,0,0,13250,6.4,15284,152,60,-7039,-4860,15.2,1325
4519674041,1,16,3,0,7,12,5,0,0,0,0,16948,7,17861,207,48,-2581,-1304,20.7,1694.8,94,3,1,12,7,12,1,1,0,0,19529,7.2,19165,252,48,2581,1304,25.2,1952.9
4512329437,0,55,1,0,4,5,7,0,0,0,0,15900,7,17743,187,68,-688,-230,18.7,1590,13,3,1,5,4,4,1,1,0,0,16588,6.8,17973,236,51,688,230,23.6,1658.8
4527590417,0,12,2,0,4,10,3,0,0,0,0,15690,6.8,18165,223,40,-2802,-1606,22.3,1569,17,3,1,10,4,16,2,1,1,0,18492,7.4,19771,227,44,2802,1606,22.7,1849.2
4500333234,1,34,3,1,5,3,5,2,1,1,0,17018,7.4,20337,262,60,1496,1664,26.2,1701.8,16,2,0,3,5,2,0,0,0,0,15522,7.2,18673,253,59,-1496,-1664,25.3,1552.2
4500168780,1,18,3,1,10,6,12,2,1,1,1,19639,7.2,19616,241,57,2778,1130,24.1,1963.9,22,5,0,6,10,8,0,0,0,0,16861,7.2,18486,240,54,-2778,-1130,24,1686.1
4526930343,1,13,1,1,6,6,6,1,1,0,0,16019,6.6,17728,193,47,-612,-167,19.3,1601.9,16,1,0,6,6,8,0,0,0,0,16631,7,17895,218,51,612,167,21.8,1663.1
4521085561,0,41,0,0,2,9,3,0,0,0,0,14525,7,18541,214,72,-3207,-1327,21.4,1452.5,27,17,1,9,2,9,1,1,0,0,17732,7.2,19868,241,52,3207,1327,24.1,1773.2
4524842008,0,19,3,0,4,6,7,1,1,0,0,14931,6.4,16059,199,46,-2698,-2458,19.9,1493.1,17,2,1,6,4,11,1,0,1,0,17629,7,18517,239,49,2698,2458,23.9,1762.9
4510803003,1,22,3,1,10,2,7,2,1,1,1,20540,7.6,20655,256,55,6921,4411,25.6,2054,12,3,0,2,10,1,0,0,0,0,13619,6.6,16244,186,40,-6921,-4411,18.6,1361.9
4516234243,1,40,5,1,2,1,3,0,0,0,0,14895,6.8,17420,236,52,773,320,23.6,1489.5,16,3,0,1,2,0,1,1,0,0,14122,6.8,17100,212,48,-773,-320,21.2,1412.2
4517953972,0,16,1,0,2,14,3,0,0,0,0,14584,6.4,16269,198,50,-4788,-2570,19.8,1458.4,49,4,1,14,2,20,1,1,0,0,19372,7.2,18839,214,44,4788,2570,21.4,1937.2
4515708213,1,14,3,1,5,2,3,0,0,0,0,15757,6.8,17869,229,52,603,-461,22.9,1575.7,85,1,0,2,5,0,1,1,0,0,15154,7,18330,246,67,-603,461,24.6,1515.4
4526627727,0,15,3,1,7,4,5,0,0,0,0,16477,7.2,18750,198,56,435,564,19.8,1647.7,14,3,0,4,7,2,1,1,0,0,16042,7,18186,258,64,-435,-564,25.8,1604.2
4520798666,0,16,3,1,5,2,5,0,0,0,0,15048,6.4,16614,182,48,384,872,18.2,1504.8,18,5,0,2,5,2,1,1,0,0,14664,6.6,15742,229,48,-384,-872,22.9,1466.4
4527662502,1,17,3,1,7,4,10,1,1,0,0,17197,7.2,18431,224,64,2348,1047,22.4,1719.7,19,2,0,4,7,4,0,0,0,0,14849,6.6,17384,206,49,-2348,-1047,20.6,1484.9
4521899160,0,19,5,0,7,7,7,1,0,1,0,16956,6.8,18758,223,64,314,611,22.3,1695.6,16,8,1,7,7,7,1,1,0,0,16642,7.2,18147,235,57,-314,-611,23.5,1664.2
4509706108,0,16,18,1,4,11,3,0,0,0,0,14958,6.6,16928,184,42,-5089,-4890,18.4,1495.8,53,1,0,11,4,7,1,0,1,1,20047,7.8,21818,243,63,5089,4890,24.3,2004.7
4526042120,0,13,1,0,5,9,5,1,1,0,0,17006,7.2,18416,245,52,-1682,-1153,24.5,1700.6,15,2,1,9,5,12,0,0,0,0,18688,7.2,19569,260,47,1682,1153,26,1868.8
4526597273,1,89,2,1,11,7,14,0,0,0,0,19866,7.6,20339,202,53,3128,2919,20.2,1986.6,15,2,0,7,11,5,0,0,0,0,16738,6.8,17420,202,48,-3128,-2919,20.2,1673.8
4515829402,0,105,1,1,6,7,3,0,0,0,0,15720,6.8,17660,187,43,-1862,-1326,18.7,1572,13,3,0,7,6,6,1,0,1,0,17582,7.2,18986,240,52,1862,1326,24,1758.2
4527531982,0,15,3,0,10,13,7,0,0,0,0,17938,7,18477,150,29,-1415,-1826,15,1793.8,72,5,1,13,10,7,0,0,0,0,19353,7.6,20303,196,60,1415,1826,19.6,1935.3
4522480570,0,12,3,1,7,6,6,0,0,0,0,17197,7.2,18196,238,45,1125,-141,23.8,1719.7,38,0,0,6,7,6,0,0,0,0,16072,7,18337,205,65,-1125,141,20.5,1607.2
4525091372,1,38,3,0,3,7,4,0,0,0,0,14343,6.6,16877,209,39,-3049,-2220,20.9,1434.3,19,1,1,7,3,9,0,0,0,0,17392,7.2,19097,241,51,3049,2220,24.1,1739.2
4527566867,0,22,1,0,2,6,0,0,0,0,0,14485,6.8,17588,233,64,-1422,-861,23.3,1448.5,68,0,1,6,2,7,1,1,0,0,15907,7,18449,235,56,1422,861,23.5,1590.7
4505373402,1,17,3,0,6,3,6,0,0,0,0,17671,7,18649,250,56,2135,1254,25,1767.1,59,4,1,3,6,4,1,1,0,0,15536,7,17395,231,52,-2135,-1254,23.1,1553.6
4520875987,0,16,1,0,4,10,6,0,0,0,0,15430,6.8,16509,207,40,-2763,-1881,20.7,1543,17,0,1,10,4,13,0,0,0,0,18193,7,18390,218,47,2763,1881,21.8,1819.3
4519890701,0,13,2,1,3,5,3,1,0,1,0,15072,7,17479,233,52,-1247,-2320,23.3,1507.2,41,2,0,5,3,6,1,1,0,0,16319,7.4,19799,222,76,1247,2320,22.2,1631.9
4524620771,0,15,0,0,1,10,1,2,1,1,0,13815,6.8,16570,219,51,-4898,-3736,21.9,1381.5,20,2,1,10,1,13,0,0,0,0,18713,7.4,20306,261,40,4898,3736,26.1,1871.3
4499835508,0,15,2,0,7,12,5,0,0,0,0,17080,7,18513,219,54,-758,-516,21.9,1708,34,2,1,12,7,10,1,1,0,0,17838,7.2,19029,209,64,758,516,20.9,1783.8
4500522425,1,18,4,0,7,2,7,1,1,0,0,17103,7,19263,221,56,2481,2112,22.1,1710.3,18,4,1,2,7,2,0,0,0,0,14622,7,17151,210,52,-2481,-2112,21,1462.2
4523672153,0,19,3,1,10,7,10,1,1,0,0,18312,6.8,18057,239,46,1250,-226,23.9,1831.2,17,4,0,7,10,5,1,0,1,0,17062,6.8,18283,206,57,-1250,226,20.6,1706.2
4521220052,1,14,1,1,7,4,2,1,1,0,0,15924,7,17965,211,45,961,1114,21.1,1592.4,13,2,0,4,7,3,0,0,0,0,14963,6.6,16851,199,38,-961,-1114,19.9,1496.3
4525239809,0,16,1,0,4,7,3,0,0,0,0,15122,6.8,17880,216,53,-1740,-46,21.6,1512.2,15,2,1,7,4,7,0,0,0,0,16862,7,17926,195,53,1740,46,19.5,1686.2
4520853492,0,19,2,0,11,7,14,1,0,1,0,18361,7,18709,234,43,1531,1680,23.4,1836.1,12,2,1,7,11,13,1,1,0,0,16830,6.8,17029,207,44,-1531,-1680,20.7,1683
4492740731,1,23,8,1,4,6,3,0,0,0,0,15888,6.8,17305,229,57,-209,-732,22.9,1588.8,17,7,0,6,4,8,1,1,0,0,16097,6.8,18037,232,43,209,732,23.2,1609.7
4500199178,0,16,2,0,5,8,6,1,0,1,0,15717,6.6,16971,196,60,-646,-960,19.6,1571.7,16,3,1,8,5,8,1,1,0,0,16363,6.8,17931,222,31,646,960,22.2,1636.3
4497853195,1,17,5,1,9,3,11,0,0,0,0,19153,7.4,20631,262,51,4003,2755,26.2,1915.3,18,2,0,3,9,3,1,1,0,0,15150,7.2,17876,225,55,-4003,-2755,22.5,1515
4525064823,1,17,4,0,9,6,7,1,0,1,0,17530,6.8,18078,238,48,2063,1430,23.8,1753,40,2,1,6,9,3,0,0,0,0,15467,6.8,16648,189,48,-2063,-1430,18.9,1546.7
4527328545,1,14,4,1,10,3,9,0,0,0,0,18389,7,18618,227,64,5191,4111,22.7,1838.9,14,2,0,3,10,3,0,0,0,0,13198,6.2,14507,162,40,-5191,-4111,16.2,1319.8
4512906607,0,16,2,1,7,2,8,0,0,0,0,17381,7.2,18931,258,42,2389,892,25.8,1738.1,18,2,0,2,7,2,1,1,0,0,14992,7,18039,216,56,-2389,-892,21.6,1499.2
4525207447,1,49,4,0,4,3,6,0,0,0,0,15091,7.2,18237,215,39,-1516,-441,21.5,1509.1,16,7,1,3,4,3,1,1,0,0,16607,7,18678,267,54,1516,441,26.7,1660.7
4513010497,0,12,2,0,2,8,1,0,0,0,0,15097,7,18355,223,72,-2575,-982,22.3,1509.7,12,3,1,8,2,9,1,1,0,0,17672,7.2,19337,226,44,2575,982,22.6,1767.2
4524248019,1,15,1,1,7,3,6,1,1,0,0,16272,7,18613,232,48,1471,806,23.2,1627.2,12,1,0,3,7,3,0,0,0,0,14801,6.8,17807,239,45,-1471,-806,23.9,1480.1
4522136543,1,11,3,0,6,8,6,2,1,1,0,16618,7,17861,206,69,-702,746,20.6,1661.8,16,1,1,8,6,11,0,0,0,0,17320,6.4,17115,206,38,702,-746,20.6,1732
4493204321,0,15,2,0,2,8,1,0,0,0,0,14826,6.6,16327,222,37,-1635,-1544,22.2,1482.6,17,4,1,8,2,12,2,1,1,0,16461,6.8,17871,210,50,1635,1544,21,1646.1
4520775356,1,14,3,1,11,2,8,2,1,1,0,19354,7.2,20036,251,48,5462,3677,25.1,1935.4,15,0,0,2,11,2,0,0,0,0,13892,6.8,16359,192,51,-5462,-3677,19.2,1389.2
4502578758,1,21,2,1,7,4,12,0,0,0,0,17380,6.8,18705,232,50,2615,2028,23.2,1738,14,3,0,4,7,3,0,0,0,0,14765,6.6,16677,181,56,-2615,-2028,18.1,1476.5
4526235126,1,15,2,1,5,3,9,0,0,0,0,16952,7.2,19223,239,52,790,83,23.9,1695.2,14,4,0,3,5,3,0,0,0,0,16162,7.2,19140,251,76,-790,-83,25.1,1616.2
4490673829,1,84,2,1,4,5,11,0,0,0,0,16316,6.6,17968,241,62,1193,1453,24.1,1631.6,14,3,0,5,4,5,0,0,0,0,15123,6.4,16515,208,44,-1193,-1453,20.8,1512.3
4506722541,0,11,0,0,0,8,0,0,0,0,0,13608,6.6,16690,229,52,-4785,-3229,22.9,1360.8,13,1,1,8,0,11,2,1,1,0,18393,7.2,19919,239,64,4785,3229,23.9,1839.3
4525932869,0,19,4,1,8,14,9,1,1,0,0,16227,6.6,16987,197,48,-3055,-2672,19.7,1622.7,19,2,0,14,8,15,0,0,0,0,19282,7.2,19659,214,44,3055,2672,21.4,1928.2
4527350448,1,20,2,1,8,10,5,1,1,0,0,16285,6.4,16278,183,48,-1655,-1008,18.3,1628.5,16,3,0,10,8,9,0,0,0,0,17940,6.6,17286,189,36,1655,1008,18.9,1794
4527306086,1,11,2,1,15,10,19,1,1,0,0,19407,7.4,19360,217,42,1259,550,21.7,1940.7,11,2,0,10,15,11,0,0,0,0,18148,7,18810,193,54,-1259,-550,19.3,1814.8
4501239867,0,11,1,0,8,8,10,0,0,0,0,17208,7.2,18713,231,45,-737,667,23.1,1720.8,12,1,1,8,8,10,0,0,0,0,17945,6.8,18046,239,29,737,-667,23.9,1794.5
4527573382,0,63,2,1,2,5,1,1,0,1,0,15915,7.2,18778,245,65,-255,-545,24.5,1591.5,15,1,0,5,2,7,1,1,0,0,16170,7.2,19323,197,63,255,545,19.7,1617
4517803168,1,20,3,1,13,6,12,0,0,0,0,19012,7.2,18944,210,54,2194,1814,21,1901.2,19,2,0,6,13,9,0,0,0,0,16818,6.8,17130,195,49,-2194,-1814,19.5,1681.8
4522201400,1,20,1,1,13,5,14,1,0,1,1,20861,7,18819,213,45,5245,2754,21.3,2086.1,14,0,0,5,13,7,0,0,0,0,15616,6.4,16065,195,40,-5245,-2754,19.5,1561.6
4524546153,0,16,6,1,5,5,5,0,0,0,0,16051,6.8,16995,235,48,-290,-1061,23.5,1605.1,17,6,0,5,5,7,1,1,0,0,16341,6.8,18056,245,35,290,1061,24.5,1634.1
4525911356,0,18,2,0,5,3,9,1,1,0,0,16380,6.8,18331,229,46,-115,480,22.9,1638,13,1,1,3,5,3,1,0,1,1,16495,7,17851,225,54,115,-480,22.5,1649.5
4515536584,0,16,3,1,4,4,4,1,0,1,0,15420,6.6,16188,185,61,-634,-1526,18.5,1542,21,3,0,4,4,4,1,1,0,0,16054,6.8,17714,236,52,634,1526,23.6,1605.4
4527457700,1,12,5,1,8,4,11,1,1,0,0,18320,7,18926,244,56,3461,1985,24.4,1832,20,3,0,4,8,2,0,0,0,0,14859,6.6,16941,217,36,-3461,-1985,21.7,1485.9
4522454983,1,18,2,1,6,6,5,2,1,1,0,16604,7,17994,240,56,867,420,24,1660.4,16,4,0,6,6,3,0,0,0,0,15737,6.8,17574,205,40,-867,-420,20.5,1573.7
4515845230,0,13,3,0,4,5,5,0,0,0,0,15610,7,18203,184,63,-215,155,18.4,1561,14,1,1,5,4,5,0,0,0,0,15825,7,18048,221,43,215,-155,22.1,1582.5
4508384732,0,17,0,1,10,5,8,0,0,0,0,17403,7,18532,181,40,1515,1112,18.1,1740.3,16,5,0,5,10,7,1,1,0,0,15888,7,17420,231,44,-1515,-1112,23.1,1588.8
4521375608,1,17,2,0,7,5,7,1,1,0,0,16030,6.8,17738,180,66,-114,433,18,1603,15,1,1,5,7,4,0,0,0,0,16144,6.8,17305,233,40,114,-433,23.3,1614.4
4525764211,0,11,0,0,2,6,2,0,0,0,0,14756,6.8,17221,217,50,-1942,-407,21.7,1475.6,10,3,1,6,2,6,1,1,0,0,16698,6.6,17628,212,69,1942,407,21.2,1669.8
4510122654,0,13,2,0,4,7,3,0,0,0,0,14156,6.6,16075,177,43,-3906,-2509,17.7,1415.6,13,0,1,7,4,7,0,0,0,1,18062,7.2,18584,233,48,3906,2509,23.3,1806.2
4525297517,0,18,4,1,7,8,7,0,0,0,0,16927,6.8,17042,223,42,-498,-861,22.3,1692.7,21,3,0,8,7,7,0,0,0,0,17425,7,17903,228,51,498,861,22.8,1742.5
4512606539,1,16,2,1,7,3,11,1,1,0,0,17365,6.8,17243,223,56,2208,-313,22.3,1736.5,13,2,0,3,7,6,0,0,0,0,15157,6.8,17556,192,56,-2208,313,19.2,1515.7
4513373886,1,17,1,1,4,5,2,0,0,0,0,15226,6.8,17774,168,67,-1667,-654,16.8,1522.6,16,0,0,5,4,6,0,0,0,0,16893,6.8,18428,227,55,1667,654,22.7,1689.3
4519670030,0,18,2,0,8,7,7,0,0,0,0,17123,6.8,17730,190,51,1110,974,19,1712.3,16,3,1,7,8,9,1,1,0,0,16013,6.8,16756,161,52,-1110,-974,16.1,1601.3
4518966647,0,12,2,0,3,7,2,1,1,0,0,14663,6.8,17795,206,59,-1984,-715,20.6,1466.3,13,1,1,7,3,9,0,0,0,0,16647,7,18510,205,52,1984,715,20.5,1664.7
4521831054,0,44,4,1,9,6,8,1,0,1,0,17897,7.2,19344,217,53,1692,1998,21.7,1789.7,12,3,0,6,9,8,1,1,0,0,16205,7,17346,206,44,-1692,-1998,20.6,1620.5
4508674756,0,15,4,0,2,11,2,0,0,0,0,13418,5.8,13877,175,32,-5710,-4952,17.5,1341.8,94,1,1,11,2,15,2,1,1,0,19128,7.2,18829,213,63,5710,4952,21.3,1912.8
4513116527,0,14,7,0,6,6,7,1,0,1,0,15928,6.8,17872,195,43,806,371,19.5,1592.8,15,3,1,6,6,7,1,1,0,0,15122,6.8,17501,200,44,-806,-371,20,1512.2
4506388090,0,12,5,0,3,12,2,1,0,1,0,15111,6.8,17710,210,68,-3620,-2690,21,1511.1,17,4,1,12,3,9,1,1,0,0,18731,7.2,20400,236,45,3620,2690,23.6,1873.1
4514404370,1,19,2,1,8,2,8,0,0,0,0,17101,7,18836,237,45,3056,1805,23.7,1710.1,15,3,0,2,8,2,0,0,0,0,14045,6.6,17031,194,48,-3056,-1805,19.4,1404.5
4520391228,1,38,1,0,8,5,10,1,1,0,0,17194,7.2,19279,200,71,2562,3016,20,1719.4,14,3,1,5,8,4,0,0,0,0,14632,6.4,16263,184,44,-2562,-3016,18.4,1463.2
4522035012,1,16,4,1,6,5,2,1,0,1,0,16565,7,17877,214,51,824,521,21.4,1656.5,15,4,0,5,6,2,1,1,0,0,15741,6.8,17356,212,45,-824,-521,21.2,1574.1
4502034096,0,18,4,0,8,10,10,1,1,0,0,16943,6.8,17157,208,37,-1074,-1632,20.8,1694.3,141,4,1,10,8,10,1,0,1,0,18017,7,18789,229,56,1074,1632,22.9,1801.7
4520842972,1,13,2,1,7,4,8,1,1,0,0,17568,7.2,19108,241,56,1975,802,24.1,1756.8,16,1,0,4,7,5,0,0,0,0,15593,7,18306,229,48,-1975,-802,22.9,1559.3
4527513607,0,27,4,0,6,8,10,0,0,0,0,17250,7.2,18763,206,60,86,467,20.6,1725,65,2,1,8,6,9,2,1,1,0,17164,7,18296,197,60,-86,-467,19.7,1716.4
4507100108,1,17,3,1,4,2,5,1,0,1,0,16559,7,17552,216,52,1928,257,21.6,1655.9,12,5,0,2,4,1,1,1,0,0,14631,6.6,17295,248,48,-1928,-257,24.8,1463.1
4500906460,0,14,1,0,1,3,0,0,0,0,0,14351,6.6,17173,218,60,-982,-1614,21.8,1435.1,19,0,1,3,1,2,1,1,0,0,15333,7.4,18787,219,48,982,1614,21.9,1533.3
4519464273,0,29,3,1,2,5,4,0,0,0,0,14735,6.6,16525,236,40,-1751,-2530,23.6,1473.5,31,5,0,5,2,6,0,0,0,0,16486,7,19055,223,68,1751,2530,22.3,1648.6
4495208776,1,14,5,1,9,1,17,2,1,1,0,18070,7.2,19270,235,55,3828,2447,23.5,1807,16,1,0,1,9,0,0,0,0,0,14242,6.6,16823,214,68,-3828,-2447,21.4,1424.2
4494851448,0,18,5,1,4,3,5,1,1,0,0,15449,6.8,17026,206,52,423,-315,20.6,1544.9,18,3,0,3,4,1,0,0,0,0,15026,6.6,17341,254,44,-423,315,25.4,1502.6
4526207203,1,24,4,1,8,5,6,0,0,0,0,17581,7,18639,243,45,1839,312,24.3,1758.1,122,1,0,5,8,2,1,1,0,0,15742,7.2,18327,221,45,-1839,-312,22.1,1574.2
4507088738,0,40,1,0,4,6,3,1,0,1,0,15505,6.8,18109,215,40,-875,-363,21.5,1550.5,12,4,1,6,4,4,1,1,0,0,16380,7.2,18472,232,48,875,363,23.2,1638
4527233294,1,14,12,1,8,8,12,0,0,0,0,16873,6.8,17879,215,45,375,296,21.5,1687.3,40,1,0,8,8,14,1,1,0,0,16498,7,17583,202,40,-375,-296,20.2,1649.8
4518611921,0,49,3,0,4,10,7,0,0,0,0,14755,6.2,15569,213,39,-4095,-1033,21.3,1475.5,15,0,1,10,4,19,1,1,0,0,18850,6.6,16602,199,56,4095,1033,19.9,1885
4510212768,1,16,1,1,10,6,11,0,0,0,0,18081,7,18813,207,63,2273,1714,20.7,1808.1,14,0,0,6,10,10,0,0,0,0,15808,6.8,17099,220,41,-2273,-1714,22,1580.8
4527098797,1,84,3,0,5,9,7,0,0,0,0,15791,7,17342,192,57,-1892,-580,19.2,1579.1,11,1,1,9,5,12,0,0,0,0,17683,7.2,17922,205,40,1892,580,20.5,1768.3
4522145954,0,10,4,0,1,6,0,1,1,0,0,13480,6.4,16396,215,52,-3137,-2097,21.5,1348,22,1,1,6,1,10,0,0,0,0,16617,7,18493,233,49,3137,2097,23.3,1661.7
4519316312,1,12,2,1,8,7,10,0,0,0,0,17946,7.2,18778,204,48,2401,727,20.4,1794.6,15,0,0,7,8,5,0,0,0,0,15545,6.8,18051,187,51,-2401,-727,18.7,1554.5
4523556041,1,10,9,0,10,10,10,1,1,0,0,17754,7,18278,195,52,292,1026,19.5,1775.4,124,0,1,10,10,12,1,0,1,0,17462,6.8,17252,190,40,-292,-1026,19,1746.2
4516727076,1,14,1,0,4,9,3,0,0,0,0,16172,6.8,17632,221,48,-1460,-1134,22.1,1617.2,15,1,1,9,4,15,1,1,0,0,17632,7.2,18766,223,56,1460,1134,22.3,1763.2
4526702861,0,16,0,1,2,2,0,0,0,0,0,14828,7.2,18414,237,68,-507,343,23.7,1482.8,14,3,0,2,2,3,1,1,0,0,15335,7,18071,260,40,507,-343,26,1533.5
4516522462,1,17,1,0,7,10,5,0,0,0,0,16589,7,18188,188,57,-3242,-950,18.8,1658.9,14,3,1,10,7,11,1,1,0,1,19831,7.2,19138,253,54,3242,950,25.3,1983.1
4526645317,1,12,2,0,3,7,5,0,0,0,0,15521,7,17703,210,63,-1079,233,21,1552.1,48,1,1,7,3,14,1,1,0,0,16600,7,17470,215,44,1079,-233,21.5,1660
4522288723,1,17,3,1,6,3,9,1,1,0,0,16198,6.8,17866,226,44,1873,1987,22.6,1619.8,18,2,0,3,6,4,0,0,0,0,14325,6.4,15879,179,44,-1873,-1987,17.9,1432.5
4514518973,0,36,6,0,1,10,1,0,0,0,0,13125,6.2,15273,167,59,-4596,-2815,16.7,1312.5,17,5,1,10,1,11,1,1,0,0,17721,7.2,18088,243,46,4596,2815,24.3,1772.1
4499735549,1,30,4,0,7,3,10,1,1,0,0,16065,6.8,17018,200,53,1322,148,20,1606.5,40,5,1,3,7,2,0,0,0,0,14743,6.6,16870,213,35,-1322,-148,21.3,1474.3
4506389635,1,15,3,1,6,7,5,0,0,0,0,16940,7.2,17909,246,38,566,-57,24.6,1694,16,4,0,7,6,11,0,0,0,0,16374,7.2,17966,219,37,-566,57,21.9,1637.4
4526832449,0,15,3,1,7,9,9,1,0,1,1,17655,6.4,16585,203,52,-134,-1518,20.3,1765.5,16,2,0,9,7,16,1,1,0,0,17789,7,18103,217,53,134,1518,21.7,1778.9
4513221186,0,11,3,1,8,6,9,1,1,0,0,16707,6.8,17380,193,44,-724,1250,19.3,1670.7,17,4,0,6,8,7,0,0,0,1,17431,6.4,16130,216,36,724,-1250,21.6,1743.1
4517507679,0,86,1,0,6,11,5,0,0,0,0,15214,7,17796,171,48,-3709,-1635,17.1,1521.4,18,1,1,11,6,10,0,0,0,0,18923,7.2,19431,228,40,3709,1635,22.8,1892.3
4522494083,1,15,3,1,12,5,13,0,0,0,0,19835,7.4,19690,223,48,4675,3054,22.3,1983.5,13,2,0,5,12,5,1,1,0,0,15160,6.8,16636,169,48,-4675,-3054,16.9,1516
4525366511,1,18,2,0,1,3,3,0,0,0,0,14289,6.8,17513,246,41,-1222,-874,24.6,1428.9,11,4,1,3,1,3,2,1,1,0,15511,6.8,18387,248,60,1222,874,24.8,1551.1
4513275057,0,20,6,1,8,2,8,1,1,0,0,16846,7.4,19790,224,54,2487,1963,22.4,1684.6,24,5,0,2,8,1,0,0,0,0,14359,6.8,17827,223,48,-2487,-1963,22.3,1435.9
4526260032,0,14,3,0,6,12,3,1,0,1,0,15488,6.8,17274,196,60,-4858,-1631,19.6,1548.8,19,5,1,12,6,15,1,1,0,1,20346,6.8,18905,214,70,4858,1631,21.4,2034.6
4514274413,1,16,2,1,7,10,8,0,0,0,0,16855,6.8,17721,218,62,-1678,-959,21.8,1685.5,14,1,0,10,7,14,1,1,0,0,18533,7,18680,232,48,1678,959,23.2,1853.3
4522086611,1,17,2,0,5,5,4,1,1,0,0,16660,7,19188,217,55,785,1439,21.7,1666,18,2,1,5,5,6,0,0,0,0,15875,6.8,17749,200,48,-785,-1439,20,1587.5
4509576274,0,14,1,1,10,5,9,1,1,0,0,18611,7.6,20169,225,68,2819,3222,22.5,1861.1,17,2,0,5,10,6,0,0,0,0,15792,6.8,16947,211,49,-2819,-3222,21.1,1579.2
4525144811,0,17,0,0,8,8,5,1,0,1,0,18233,7.4,19767,256,56,363,-533,25.6,1823.3,78,2,1,8,8,13,1,1,0,0,17870,7.6,20300,239,52,-363,533,23.9,1787
4516186940,0,38,2,1,6,5,10,1,0,1,0,16616,6.6,17450,215,56,930,2011,21.5,1661.6,15,0,0,5,6,7,0,0,0,0,15686,6.2,15439,168,60,-930,-2011,16.8,1568.6
4509107682,1,17,2,0,6,7,8,0,0,0,0,16107,7.2,17763,231,39,-621,-23,23.1,1610.7,16,5,1,7,6,9,1,1,0,0,16728,6.8,17786,216,43,621,23,21.6,1672.8
4527063486,1,28,2,1,7,5,12,0,0,0,0,16674,6.8,17188,204,47,111,-199,20.4,1667.4,23,1,0,5,7,5,2,1,1,0,16563,7,17387,221,48,-111,199,22.1,1656.3
4519284907,1,16,3,1,7,2,12,1,1,0,0,16671,6.8,17285,216,48,2644,1400,21.6,1667.1,14,5,0,2,7,1,1,0,1,0,14027,6.4,15885,228,52,-2644,-1400,22.8,1402.7
4514329925,1,17,2,0,9,6,6,1,1,0,0,17261,7,18577,219,56,1704,2023,21.9,1726.1,15,1,1,6,9,8,0,0,0,0,15557,6.6,16554,182,42,-1704,-2023,18.2,1555.7
4527297210,1,14,2,0,6,2,4,2,1,1,0,16886,7.2,18724,242,64,2881,2005,24.2,1688.6,141,1,1,2,6,2,0,0,0,0,14005,6.8,16719,186,48,-2881,-2005,18.6,1400.5
4527454309,0,60,2,1,10,7,7,2,1,1,0,18226,7.2,18871,211,53,1063,1153,21.1,1822.6,16,9,0,7,10,8,0,0,0,0,17163,7,17718,229,52,-1063,-1153,22.9,1716.3
4513780081,1,16,2,1,11,6,13,1,1,0,0,18136,7,18077,194,55,649,343,19.4,1813.6,15,3,0,6,11,8,0,0,0,0,17487,7,17734,239,44,-649,-343,23.9,1748.7
4510137231,0,15,1,1,1,0,0,1,0,1,0,14712,7,17631,253,62,-132,-1473,25.3,1471.2,12,2,0,0,1,0,1,1,0,0,14844,7,19104,264,68,132,1473,26.4,1484.4
4521185772,1,15,2,1,7,8,4,1,0,1,0,16420,7,18391,224,49,-1250,-1034,22.4,1642,17,2,0,8,7,6,1,1,0,0,17670,7.2,19425,239,55,1250,1034,23.9,1767
4527007820,1,17,2,0,9,10,9,0,0,0,0,17678,6.8,17263,190,40,-1213,848,19,1767.8,15,3,1,10,9,19,1,1,0,1,18891,6.6,16415,182,37,1213,-848,18.2,1889.1
4519672552,0,29,3,0,9,7,10,0,0,0,0,17126,6.8,17604,195,52,1386,679,19.5,1712.6,18,2,1,7,9,4,1,1,0,0,15740,6.6,16925,202,48,-1386,-679,20.2,1574
4515454034,0,16,3,0,4,14,4,0,0,0,0,15001,6.6,16275,205,37,-5120,-4011,20.5,1500.1,46,3,1,14,4,16,1,0,1,0,20121,7.4,20286,233,64,5120,4011,23.3,2012.1
4519982625,0,16,1,1,4,6,2,0,0,0,0,15416,7.2,18403,214,51,-2219,-677,21.4,1541.6,15,3,0,6,4,7,2,1,1,0,17635,7.2,19080,237,56,2219,677,23.7,1763.5
4508717293,0,18,3,1,5,8,3,0,0,0,0,15177,6.6,16094,206,33,-2399,-2317,20.6,1517.7,15,3,0,8,5,7,1,1,0,0,17576,7,18411,243,47,2399,2317,24.3,1757.6
4501146183,0,14,0,1,4,4,2,0,0,0,0,15853,6.8,18455,229,64,20,-1382,22.9,1585.3,18,2,0,4,4,3,1,1,0,0,15833,7.4,19837,232,69,-20,1382,23.2,1583.3
4518072555,0,16,5,0,8,5,10,1,1,0,0,17513,7,18498,234,44,834,861,23.4,1751.3,26,1,1,5,8,7,0,0,0,0,16679,6.8,17637,215,60,-834,-861,21.5,1667.9
4511479972,0,15,6,0,8,8,9,0,0,0,0,16345,7,17692,206,43,-1208,-213,20.6,1634.5,18,5,1,8,8,9,2,1,1,0,17553,7,17905,223,56,1208,213,22.3,1755.3
4520301016,0,13,11,0,5,9,6,0,0,0,0,14826,6.8,16490,176,40,-2907,-3389,17.6,1482.6,38,0,1,9,5,2,1,1,0,0,17733,7.4,19879,229,65,2907,3389,22.9,1773.3
4492410898,0,16,2,1,7,6,7,0,0,0,0,16440,6.8,17181,197,37,-635,-1449,19.7,1644,11,5,0,6,7,8,1,1,0,0,17075,7,18630,246,49,635,1449,24.6,1707.5
4525558466,1,18,3,1,4,3,4,1,1,0,0,16571,7.2,18893,258,52,1749,1270,25.8,1657.1,20,3,0,3,4,3,0,0,0,0,14822,6.6,17623,232,49,-1749,-1270,23.2,1482.2
4516194928,0,17,3,0,4,10,10,0,0,0,0,15928,6.8,17242,204,56,-2760,-1949,20.4,1592.8,12,3,1,10,4,13,1,1,0,0,18688,7.2,19191,233,55,2760,1949,23.3,1868.8
4517932062,0,14,5,1,7,10,11,1,0,1,0,17759,7.2,18043,246,36,-695,-2159,24.6,1775.9,15,1,0,10,7,6,0,0,0,0,18454,7.4,20202,214,64,695,2159,21.4,1845.4
4527289759,1,18,2,0,2,4,1,0,0,0,0,13995,7,17605,176,71,-1171,-854,17.6,1399.5,51,5,1,4,2,6,1,1,0,0,15166,7,18459,218,64,1171,854,21.8,1516.6
4500388564,1,16,4,1,5,8,5,1,0,1,0,16607,7,17949,223,68,-1001,-543,22.3,1660.7,54,2,0,8,5,10,1,1,0,0,17608,7,18492,229,41,1001,543,22.9,1760.8
4509560405,1,15,0,0,19,4,22,1,1,0,0,22173,7.4,20408,234,45,7154,6032,23.4,2217.3,12,0,1,4,19,5,1,0,1,0,15019,6,14376,189,38,-7154,-6032,18.9,1501.9
4506470828,0,15,4,0,3,7,1,0,0,0,0,14114,6.8,17331,215,36,-3063,-2014,21.5,1411.4,19,5,1,7,3,12,1,1,0,0,17177,7.4,19345,227,60,3063,2014,22.7,1717.7
4506730764,1,78,18,0,6,3,4,2,1,1,1,18704,7.6,20796,260,67,3917,2196,26,1870.4,39,0,1,3,6,1,0,0,0,0,14787,7,18600,216,60,-3917,-2196,21.6,1478.7
4522252043,1,13,0,1,6,3,8,0,0,0,0,18236,7.2,19626,234,76,3586,3431,23.4,1823.6,13,1,0,3,6,4,0,0,0,0,14650,6.6,16195,221,47,-3586,-3431,22.1,1465
4511683858,0,16,6,0,5,7,4,0,0,0,0,15437,7,17811,195,68,-2205,-1308,19.5,1543.7,17,4,1,7,5,6,1,1,0,0,17642,7.2,19119,270,40,2205,1308,27,1764.2
4514830749,0,18,3,0,7,10,7,1,1,0,0,15842,6.6,17223,216,35,-3572,-1330,21.6,1584.2,21,5,1,10,7,10,0,0,0,1,19414,7,18553,225,36,3572,1330,22.5,1941.4
4522438327,1,33,5,0,4,4,5,1,1,0,0,16476,6.6,17137,225,50,896,-140,22.5,1647.6,13,5,1,4,4,1,1,0,1,0,15580,6.8,17277,227,54,-896,140,22.7,1558
4526683512,1,16,5,0,8,7,9,1,0,1,0,17075,7,17360,198,49,399,-182,19.8,1707.5,15,2,1,7,8,6,1,1,0,0,16676,7,17542,219,65,-399,182,21.9,1667.6
4525780580,1,108,2,1,10,5,6,1,1,0,0,18327,7.2,18553,219,62,2980,1865,21.9,1832.7,10,3,0,5,10,3,0,0,0,0,15347,6.8,16688,233,43,-2980,-1865,23.3,1534.7
4526035454,0,16,3,0,5,8,6,0,0,0,0,15432,7,17869,225,46,-2228,-745,22.5,1543.2,17,2,1,8,5,8,1,1,0,0,17660,7,18614,247,56,2228,745,24.7,1766
4524141985,0,18,2,0,2,3,3,0,0,0,0,14510,6.8,17801,247,36,-1456,-251,24.7,1451,79,3,1,3,2,5,2,1,1,0,15966,7,18052,252,56,1456,251,25.2,1596.6
4527381514,0,15,3,0,2,8,1,1,1,0,0,14426,6.6,17051,210,60,-2709,-1468,21,1442.6,12,4,1,8,2,9,0,0,0,0,17135,7,18519,239,48,2709,1468,23.9,1713.5
4511994182,1,15,0,0,11,5,9,1,1,0,1,19632,7,18732,222,60,4648,2498,22.2,1963.2,12,0,1,5,11,7,0,0,0,0,14984,6.4,16234,181,37,-4648,-2498,18.1,1498.4
4502131494,1,13,1,0,9,8,17,1,1,0,0,17923,7,17698,189,54,-37,-100,18.9,1792.3,14,1,1,8,9,9,0,0,0,0,17960,7,17798,202,60,37,100,20.2,1796
4493017629,1,21,3,1,4,4,3,0,0,0,0,16297,6.8,17730,237,62,1772,1255,23.7,1629.7,17,1,0,4,4,4,0,0,0,0,14525,6.6,16475,202,36,-1772,-1255,20.2,1452.5
4499811143,1,15,0,1,9,3,9,0,0,0,1,20026,7.2,19142,246,51,6773,5215,24.6,2002.6,82,2,0,3,9,4,1,1,0,0,13253,6.2,13927,148,32,-6773,-5215,14.8,1325.3
4525832836,0,17,4,1,5,4,3,1,1,0,0,15926,6.6,16415,247,48,-299,-1889,24.7,1592.6,36,2,0,4,5,4,0,0,0,0,16225,7,18304,230,49,299,1889,23,1622.5
4526363486,1,20,3,0,4,8,5,1,1,0,0,15579,6.8,18054,203,67,-2227,-1077,20.3,1557.9,15,4,1,8,4,6,1,0,1,0,17806,7.2,19131,254,53,2227,1077,25.4,1780.6
4527216964,1,37,4,0,3,7,4,0,0,0,0,15270,7,18043,235,55,-1429,1040,23.5,1527,85,5,1,7,3,8,0,0,0,0,16699,6.4,17003,204,39,1429,-1040,20.4,1669.9
4516583288,0,12,2,0,4,10,4,1,1,0,0,15994,7,18031,229,64,-2519,-1610,22.9,1599.4,15,4,1,10,4,15,0,0,0,0,18513,7.2,19641,238,39,2519,1610,23.8,1851.3
4516987544,0,13,3,1,3,3,3,0,0,0,0,16064,7.2,18651,247,56,1117,472,24.7,1606.4,17,2,0,3,3,0,2,1,1,0,14947,6.8,18179,229,54,-1117,-472,22.9,1494.7
4498628249,1,20,4,1,8,8,12,1,1,0,0,16796,6.6,16424,185,48,700,1221,18.5,1679.6,15,3,0,8,8,14,0,0,0,0,16096,6.2,15203,175,28,-700,-1221,17.5,1609.6
4526211011,1,14,2,0,5,7,4,0,0,0,0,15553,6.6,15768,203,40,-977,-2180,20.3,1555.3,17,0,1,7,5,5,2,1,1,0,16530,7,17948,222,54,977,2180,22.2,1653
4519844480,0,41,0,0,4,17,4,0,0,0,0,14838,6,15075,180,44,-6265,-3518,18,1483.8,14,13,1,17,4,24,1,0,1,0,21103,7,18593,194,28,6265,3518,19.4,2110.3
4518050280,1,15,6,0,4,4,4,0,0,0,0,15506,6.6,17801,229,50,-154,663,22.9,1550.6,19,2,1,4,4,7,1,1,0,0,15660,6.6,17138,222,44,154,-663,22.2,1566
4526670419,0,41,3,0,6,10,3,0,0,0,0,16531,7.4,19310,226,59,-1114,-398,22.6,1653.1,37,3,1,10,6,10,1,1,0,0,17645,7.4,19708,199,58,1114,398,19.9,1764.5
4522402589,0,14,3,1,7,12,9,0,0,0,0,16000,6.4,16324,190,44,-2111,-2875,19,1600,16,4,0,12,7,11,0,0,0,0,18111,7.2,19199,221,51,2111,2875,22.1,1811.1
4514530513,0,12,1,0,6,11,5,0,0,0,0,16281,6.8,17569,209,53,-2082,-2125,20.9,1628.1,14,0,1,11,6,9,1,1,0,0,18363,7.4,19694,206,64,2082,2125,20.6,1836.3
4515527717,1,16,3,1,7,8,7,1,1,0,0,17442,6.8,17426,236,36,153,-519,23.6,1744.2,18,3,0,8,7,8,0,0,0,0,17289,6.8,17945,226,48,-153,519,22.6,1728.9
4519862589,1,16,2,1,10,6,12,1,0,1,0,18692,7.4,19767,248,48,2830,1589,24.8,1869.2,12,2,0,6,10,4,0,0,0,0,15862,6.8,18178,210,39,-2830,-1589,21,1586.2
4519645138,1,19,1,0,5,6,4,1,1,0,0,17028,7,18519,235,60,1761,2297,23.5,1702.8,15,5,1,6,5,9,1,0,1,0,15267,6.6,16222,177,36,-1761,-2297,17.7,1526.7
4513383518,0,53,2,0,0,3,0,1,1,0,0,13787,6.8,17848,225,52,-2153,-1344,22.5,1378.7,14,4,1,3,0,3,0,0,0,0,15940,7.2,19192,237,56,2153,1344,23.7,1594
4526291828,1,17,0,0,5,2,3,2,1,1,0,17956,7,18251,271,50,4594,2745,27.1,1795.6,18,3,1,2,5,6,0,0,0,0,13362,6.4,15506,187,33,-4594,-2745,18.7,1336.2
4527018824,0,21,2,0,2,5,6,1,1,0,0,15476,6.8,17429,237,64,-781,-1559,23.7,1547.6,17,6,1,5,2,3,1,0,1,0,16257,7.2,18988,227,48,781,1559,22.7,1625.7
4520629363,1,16,2,0,4,4,3,2,1,1,0,15875,6.8,18309,234,65,455,1305,23.4,1587.5,15,4,1,4,4,6,0,0,0,0,15420,6.4,17004,233,42,-455,-1305,23.3,1542
4506971085,1,17,0,1,8,9,9,2,1,1,0,17030,6.8,17359,206,43,-493,-986,20.6,1703,15,4,0,9,8,13,0,0,0,0,17523,7.2,18345,186,44,493,986,18.6,1752.3
4521155877,0,20,2,0,3,6,1,0,0,0,0,14719,6.6,16759,214,43,-2418,-2255,21.4,1471.9,38,1,1,6,3,7,0,0,0,0,17137,7,19014,240,64,2418,2255,24,1713.7
4523110443,1,23,1,0,7,4,8,1,0,1,1,17617,6.6,17519,199,47,241,307,19.9,1761.7,25,3,1,4,7,7,1,1,0,1,17376,6.6,17212,214,58,-241,-307,21.4,1737.6
4467610572,0,15,4,1,5,4,6,1,0,1,0,16457,7,18669,229,60,1023,1754,22.9,1645.7,19,2,0,4,5,7,0,0,0,0,15434,6.6,16915,219,53,-1023,-1754,21.9,1543.4
4509643983,0,15,4,1,5,6,9,0,0,0,0,15885,6.6,16674,203,40,-75,-1566,20.3,1588.5,14,2,0,6,5,1,2,1,1,0,15960,7,18240,211,68,75,1566,21.1,1596
4493059433,1,14,0,1,10,4,10,1,0,1,1,19107,7.4,20103,230,56,3799,2856,23,1910.7,11,2,0,4,10,3,0,0,0,0,15308,6.8,17247,210,56,-3799,-2856,21,1530.8
4527471301,1,19,8,0,7,4,10,0,0,0,0,16507,6.4,16273,212,42,1114,-1294,21.2,1650.7,18,4,1,4,7,5,0,0,0,0,15393,6.8,17567,221,55,-1114,1294,22.1,1539.3
4507115446,1,14,8,0,6,4,11,1,1,0,0,16538,7.2,18707,235,55,1585,1348,23.5,1653.8,14,3,1,4,6,4,0,0,0,0,14953,6.6,17359,189,44,-1585,-1348,18.9,1495.3
4515526880,0,32,4,0,3,10,3,0,0,0,0,15067,6.6,15937,186,39,-2968,-3336,18.6,1506.7,21,1,1,10,3,11,1,1,0,0,18035,7.4,19273,214,57,2968,3336,21.4,1803.5
4505276282,0,13,3,1,7,13,11,0,0,0,0,16571,6.4,15773,178,44,-1624,-3004,17.8,1657.1,21,2,0,13,7,15,0,0,0,0,18195,7.2,18777,207,32,1624,3004,20.7,1819.5
4526464882,0,40,2,0,5,8,6,0,0,0,0,16530,7.4,19242,231,51,-1347,-1433,23.1,1653,13,15,1,8,5,6,1,1,0,0,17877,7.6,20675,231,79,1347,1433,23.1,1787.7
4509303236,1,13,2,0,6,6,9,1,1,0,0,16239,7,18439,203,52,36,-234,20.3,1623.9,19,3,1,6,6,3,0,0,0,0,16203,7.2,18673,224,50,-36,234,22.4,1620.3
4502663674,0,14,4,1,6,4,7,0,0,0,0,16624,6.8,18473,208,52,115,-256,20.8,1662.4,15,4,0,4,6,6,2,1,1,0,16509,7,18729,239,68,-115,256,23.9,1650.9
4508966614,0,20,4,0,7,11,7,1,1,0,0,15890,6.4,16536,201,39,-3280,-2301,20.1,1589,20,4,1,11,7,14,1,0,1,0,19170,7.4,18837,223,47,3280,2301,22.3,1917
4521617459,1,15,2,1,13,4,23,0,0,0,0,18957,7.4,19663,222,68,2842,1659,22.2,1895.7,15,3,0,4,13,7,1,1,0,0,16115,6.8,18004,238,64,-2842,-1659,23.8,1611.5
4502847673,1,19,4,0,11,5,10,1,1,0,0,18307,7.2,19247,228,54,3223,2804,22.8,1830.7,14,2,1,5,11,3,0,0,0,0,15084,6.6,16443,198,40,-3223,-2804,19.8,1508.4
4505820252,1,14,1,0,2,3,2,2,1,1,0,16394,7.4,20016,264,85,1447,1753,26.4,1639.4,13,3,1,3,2,1,0,0,0,0,14947,6.8,18263,227,54,-1447,-1753,22.7,1494.7
4512913820,1,47,2,0,3,12,3,1,0,1,0,15096,6.2,15306,212,50,-2483,-1696,21.2,1509.6,14,20,1,12,3,16,1,1,0,0,17579,6.6,17002,144,41,2483,1696,14.4,1757.9
4522857741,1,18,4,1,3,3,5,1,1,0,0,15200,6.8,17127,230,56,662,33,23,1520,15,4,0,3,3,3,0,0,0,0,14538,6.6,17094,202,47,-662,-33,20.2,1453.8
4523494411,1,23,5,0,3,5,3,1,1,0,0,14684,6.8,16985,217,49,-2212,-1666,21.7,1468.4,37,1,1,5,3,4,0,0,0,0,16896,7.2,18651,258,57,2212,1666,25.8,1689.6
4520806066,1,13,0,1,8,8,7,1,1,0,0,16228,6.6,16387,194,44,-412,22,19.4,1622.8,16,0,0,8,8,9,0,0,0,0,16640,6.6,16365,208,51,412,-22,20.8,1664
4526502680,1,12,2,1,9,7,10,1,1,0,0,18101,7.2,19775,213,74,1645,1489,21.3,1810.1,15,2,0,7,9,5,0,0,0,0,16456,6.8,18286,187,47,-1645,-1489,18.7,1645.6
4517814495,0,16,2,1,14,3,15,1,0,1,1,21055,7.2,19573,219,52,6744,5355,21.9,2105.5,16,3,0,3,14,3,1,1,0,0,14311,6,14218,166,53,-6744,-5355,16.6,1431.1
4525934339,0,15,1,1,4,5,2,0,0,0,0,13933,6.4,16078,199,39,-2215,-1879,19.9,1393.3,17,1,0,5,4,6,2,1,1,0,16148,6.8,17957,212,48,2215,1879,21.2,1614.8
4523577373,1,16,2,1,11,7,13,1,0,1,0,19497,7.2,18445,221,55,3611,2847,22.1,1949.7,15,0,0,7,11,9,0,0,0,0,15886,6.4,15598,165,40,-3611,-2847,16.5,1588.6
4513101725,1,15,3,0,3,4,1,0,0,0,0,15236,7.2,18474,236,41,-297,548,23.6,1523.6,15,2,1,4,3,4,1,1,0,0,15533,7,17926,205,54,297,-548,20.5,1553.3
4525230162,0,16,4,1,5,3,5,1,1,0,0,16700,7.2,18574,242,52,1928,1297,24.2,1670,15,3,0,3,5,1,0,0,0,0,14772,6.6,17277,243,47,-1928,-1297,24.3,1477.2
4519287844,1,37,3,1,5,1,11,2,1,1,0,16506,7,17981,213,52,2663,864,21.3,1650.6,16,2,0,1,5,0,0,0,0,0,13843,6.6,17117,224,46,-2663,-864,22.4,1384.3
4523260482,1,36,8,1,7,4,11,1,1,0,0,16482,6.6,16880,222,46,1086,756,22.2,1648.2,21,4,0,4,7,6,0,0,0,0,15396,6.4,16124,212,58,-1086,-756,21.2,1539.6
4525320313,1,16,4,0,3,4,2,0,0,0,0,15694,7,17920,241,48,764,-29,24.1,1569.4,18,2,1,4,3,1,1,1,0,0,14930,7,17949,221,47,-764,29,22.1,1493
4500173548,1,18,3,1,7,8,9,1,0,1,0,16276,7,17562,195,40,-1216,-629,19.5,1627.6,16,3,0,8,7,10,0,0,0,0,17492,7,18191,210,76,1216,629,21,1749.2
4508846278,0,28,2,0,12,14,14,1,0,1,0,18331,7,18445,181,52,-1572,-208,18.1,1833.1,14,3,1,14,12,17,1,1,0,0,19903,7,18653,228,40,1572,208,22.8,1990.3
4495426871,1,12,1,1,9,3,10,1,1,0,0,17347,7,18131,230,51,2547,1386,23,1734.7,16,0,0,3,9,7,0,0,0,0,14800,6.6,16745,208,60,-2547,-1386,20.8,1480
4527204318,0,19,2,0,0,9,0,0,0,0,0,15090,7,18031,238,65,-1931,-299,23.8,1509,47,5,1,9,0,13,1,1,0,0,17021,7.2,18330,220,44,1931,299,22,1702.1
4527545380,1,14,3,1,10,8,17,1,0,1,0,17799,7,18078,190,40,-333,-359,19,1779.9,16,3,0,8,10,7,1,1,0,0,18132,7.2,18437,241,59,333,359,24.1,1813.2
4497717907,0,18,1,1,4,8,6,0,0,0,0,15694,6.6,16853,202,59,-3531,-2649,20.2,1569.4,7,3,0,8,4,8,1,1,0,1,19225,7.2,19502,265,40,3531,2649,26.5,1922.5
4521559243,1,13,1,1,7,0,8,0,0,0,0,17269,7.2,19988,244,52,3425,3823,24.4,1726.9,15,2,0,0,7,0,1,1,0,0,13844,6.6,16165,228,52,-3425,-3823,22.8,1384.4
4527661727,1,20,7,0,6,6,3,1,1,0,0,16662,7,18914,237,48,619,35,23.7,1666.2,21,4,1,6,6,7,0,0,0,0,16043,7.2,18879,212,48,-619,-35,21.2,1604.3
4526793578,0,15,0,1,5,9,4,0,0,0,0,17292,7,18087,238,63,-689,-266,23.8,1729.2,11,3,0,9,5,18,1,1,0,0,17981,7,18353,214,44,689,266,21.4,1798.1
4516541266,0,51,1,0,2,5,4,1,0,1,0,14772,6.8,17784,214,59,-2395,-2173,21.4,1477.2,15,2,1,5,2,5,1,1,0,0,17167,7.4,19957,258,68,2395,2173,25.8,1716.7
4518116410,0,16,2,1,2,8,1,1,0,1,0,15157,6.8,16829,228,52,-1082,-1819,22.8,1515.7,16,4,0,8,2,4,1,1,0,0,16239,7,18648,229,40,1082,1819,22.9,1623.9
4515824128,1,19,3,1,7,6,8,0,0,0,0,16124,6.8,17018,192,52,-467,-86,19.2,1612.4,17,5,0,6,7,8,2,1,1,0,16591,6.8,17104,211,49,467,86,21.1,1659.1
4527387973,1,18,1,0,7,5,11,1,0,1,0,17881,7.2,19560,257,56,3135,2366,25.7,1788.1,12,1,1,5,7,7,0,0,0,0,14746,6.6,17194,201,36,-3135,-2366,20.1,1474.6
4525633564,1,15,4,1,10,9,12,2,1,1,0,17676,6.8,17633,186,67,1209,1019,18.6,1767.6,39,2,0,9,10,7,0,0,0,0,16467,6.8,16614,189,39,-1209,-1019,18.9,1646.7
4521175049,0,15,3,0,3,5,3,1,1,0,0,15809,6.8,17675,214,63,-1462,-1833,21.4,1580.9,17,2,1,5,3,8,1,0,1,0,17271,7.4,19508,232,56,1462,1833,23.2,1727.1
4500193521,0,17,3,1,7,4,5,1,1,0,0,16960,6.8,17503,215,59,-60,10,21.5,1696,16,5,0,4,7,7,1,0,1,1,17020,6.8,17493,222,46,60,-10,22.2,1702
4514350751,0,15,1,1,3,4,4,0,0,0,0,15372,6.8,17983,234,51,-6,-1746,23.4,1537.2,14,6,0,4,3,0,1,1,0,0,15378,7.2,19729,236,48,6,1746,23.6,1537.8
4518093474,0,17,3,1,8,9,7,1,1,0,0,16527,6.6,16884,194,52,-233,-754,19.4,1652.7,39,6,0,9,8,12,1,0,1,0,16760,6.8,17638,197,38,233,754,19.7,1676
4527258307,1,17,4,1,6,0,9,0,0,0,0,17774,6.8,18689,226,65,4232,1501,22.6,1777.4,43,4,0,0,6,0,0,0,0,0,13542,7,17188,218,62,-4232,-1501,21.8,1354.2
4502041517,1,19,6,0,3,7,3,1,0,1,0,16074,7,17776,237,48,-283,-484,23.7,1607.4,44,3,1,7,3,6,0,0,0,0,16357,7.2,18260,220,31,283,484,22,1635.7
4525376845,0,31,2,0,4,1,5,2,1,1,0,15612,7,17678,234,61,1518,1208,23.4,1561.2,16,2,1,1,4,2,0,0,0,0,14094,6.8,16470,213,50,-1518,-1208,21.3,1409.4
4519651388,0,13,2,1,10,16,7,0,0,0,0,16759,6.4,15499,163,37,-4236,-4211,16.3,1675.9,15,2,0,16,10,15,1,1,0,0,20995,7.4,19710,187,46,4236,4211,18.7,2099.5
4515194519,0,16,2,1,3,2,5,1,1,0,0,14911,6.8,16715,228,44,-224,-1942,22.8,1491.1,16,3,0,2,3,2,0,0,0,0,15135,7.2,18657,248,64,224,1942,24.8,1513.5
4523512356,1,12,1,0,8,6,14,1,1,0,0,16980,6.8,18629,218,48,-53,559,21.8,1698,19,2,1,6,8,4,0,0,0,0,17033,7,18070,240,59,53,-559,24,1703.3
4526872931,0,14,4,1,3,4,5,0,0,0,0,15776,7,17726,261,52,969,1563,26.1,1577.6,26,1,0,4,3,5,1,1,0,0,14807,6.8,16163,207,44,-969,-1563,20.7,1480.7
4527291717,0,71,4,0,4,7,2,0,0,0,0,14961,6.8,17673,215,40,-2090,-916,21.5,1496.1,18,3,1,7,4,7,1,1,0,0,17051,7,18589,239,56,2090,916,23.9,1705.1
4498211277,1,44,4,0,4,3,6,1,1,0,0,16031,7,18664,223,60,687,510,22.3,1603.1,16,8,1,3,4,1,0,0,0,0,15344,6.6,18154,254,44,-687,-510,25.4,1534.4
4515507171,1,14,3,0,5,5,4,1,1,0,0,16313,7,18652,242,47,-152,-537,24.2,1631.3,18,4,1,5,5,5,0,0,0,0,16465,7.2,19189,213,64,152,537,21.3,1646.5
4526480699,0,8,3,1,6,5,7,1,0,1,0,15964,6.8,18133,217,51,-68,963,21.7,1596.4,55,1,0,5,6,9,1,1,0,0,16032,6.8,17170,198,51,68,-963,19.8,1603.2
4518209107,1,13,3,0,13,9,12,1,1,0,0,20541,7.4,19687,260,60,2368,1767,26,2054.1,28,3,1,9,13,16,0,0,0,0,18173,6.8,17920,169,52,-2368,-1767,16.9,1817.3
4518472442,0,17,3,0,8,4,8,1,1,0,0,17415,6.8,16774,232,48,2791,1911,23.2,1741.5,40,4,1,4,8,8,0,0,0,0,14624,6.2,14863,205,26,-2791,-1911,20.5,1462.4
4493326882,0,103,6,0,6,10,5,1,1,0,1,16878,7,17994,185,64,-2636,-1390,18.5,1687.8,15,6,1,10,6,9,1,0,1,1,19514,7.4,19384,227,55,2636,1390,22.7,1951.4
4522178825,1,16,2,1,5,6,5,1,1,0,0,15901,6.8,16965,213,44,324,-409,21.3,1590.1,15,1,0,6,5,6,0,0,0,0,15577,6.6,17374,207,40,-324,409,20.7,1557.7
4525832598,1,13,3,1,4,6,6,1,1,0,0,16040,6.8,17697,235,54,-572,35,23.5,1604,69,3,0,6,4,13,0,0,0,0,16612,7,17662,221,45,572,-35,22.1,1661.2
4526594026,1,41,4,0,9,4,11,1,1,0,0,18140,7.2,20250,204,79,2793,3324,20.4,1814,18,4,1,4,9,3,0,0,0,0,15347,6.8,16926,222,36,-2793,-3324,22.2,1534.7
4492694297,1,15,0,1,11,6,9,1,1,0,0,17229,7,18401,191,40,354,736,19.1,1722.9,28,4,0,6,11,6,0,0,0,0,16875,6.8,17665,202,52,-354,-736,20.2,1687.5
4526195256,1,16,5,1,5,4,5,1,0,1,0,15916,6.8,17531,237,51,73,-806,23.7,1591.6,21,6,0,4,5,4,1,1,0,0,15843,7,18337,238,61,-73,806,23.8,1584.3
4512891978,0,13,1,1,6,4,8,1,1,0,0,15452,7,18378,191,49,-1039,827,19.1,1545.2,12,6,0,4,6,4,1,0,1,1,16491,6.8,17551,215,51,1039,-827,21.5,1649.1
4513346421,1,16,4,0,5,9,4,0,0,0,0,15999,6.8,17524,203,62,-1189,-1741,20.3,1599.9,16,4,1,9,5,5,1,1,0,0,17188,7.2,19265,224,50,1189,1741,22.4,1718.8
4527416964,0,14,5,0,3,6,3,0,0,0,0,14399,6.6,17167,221,40,-3656,-2866,22.1,1439.9,19,1,1,6,3,4,0,0,0,0,18055,7.4,20033,232,82,3656,2866,23.2,1805.5
4521066118,0,15,3,0,1,7,2,1,1,0,0,13449,6.6,16281,205,45,-4357,-4959,20.5,1344.9,54,4,1,7,1,9,0,0,0,0,17806,7.6,21240,226,79,4357,4959,22.6,1780.6
4527444282,0,13,2,0,3,9,2,1,1,0,0,13876,6.6,16521,175,47,-3248,-1706,17.5,1387.6,46,1,1,9,3,8,0,0,0,0,17124,7,18227,194,52,3248,1706,19.4,1712.4
4512728524,0,16,5,1,5,12,3,0,0,0,0,15776,6.8,16537,209,58,-3587,-2861,20.9,1577.6,16,3,0,12,5,10,2,1,1,1,19363,7.2,19398,197,56,3587,2861,19.7,1936.3
4527556875,0,18,4,1,4,3,2,1,1,0,0,15282,7,17671,232,54,-35,317,23.2,1528.2,27,1,0,3,4,4,0,0,0,0,15317,6.8,17354,206,47,35,-317,20.6,1531.7
4515671076,0,18,0,0,2,7,3,1,1,0,0,14258,6.6,16594,198,52,-3903,-2516,19.8,1425.8,21,4,1,7,2,8,0,0,0,0,18161,7.2,19110,261,48,3903,2516,26.1,1816.1
4509965953,0,15,4,0,2,11,1,0,0,0,0,14316,6.6,16505,214,48,-4885,-2721,21.4,1431.6,18,2,1,11,2,12,2,1,1,0,19201,7.4,19226,249,55,4885,2721,24.9,1920.1
4525051102,1,10,3,1,3,4,3,0,0,0,0,15482,6.8,17584,243,47,36,-928,24.3,1548.2,19,2,0,4,3,1,2,1,1,0,15446,7.2,18512,226,67,-36,928,22.6,1544.6
4515677158,0,38,5,1,5,4,6,0,0,0,0,16402,7,18713,250,43,1678,1857,25,1640.2,15,1,0,4,5,3,1,1,0,0,14724,6.6,16856,173,75,-1678,-1857,17.3,1472.4
4511386287,0,19,7,1,10,7,8,1,1,0,1,18822,7,18319,224,51,2830,1605,22.4,1882.2,21,1,0,7,10,5,1,0,1,0,15992,6.6,16714,195,47,-2830,-1605,19.5,1599.2
4508253654,1,19,2,1,11,4,6,0,0,0,0,17702,7.2,18597,216,30,1741,675,21.6,1770.2,15,4,0,4,11,2,0,0,0,0,15961,6.8,17922,211,63,-1741,-675,21.1,1596.1
4526479094,0,16,2,0,3,6,2,0,0,0,0,16178,7,19240,258,56,-183,257,25.8,1617.8,13,3,1,6,3,5,1,1,0,0,16361,7.2,18983,226,68,183,-257,22.6,1636.1
4527372782,0,14,4,0,5,3,5,0,0,0,0,15897,7,18190,226,44,485,858,22.6,1589.7,15,3,1,3,5,3,0,0,0,0,15412,6.8,17332,238,31,-485,-858,23.8,1541.2
4516959189,1,13,1,0,6,6,5,0,0,0,0,16248,7.4,19928,204,64,131,1207,20.4,1624.8,14,1,1,6,6,4,0,0,0,0,16117,7,18721,211,44,-131,-1207,21.1,1611.7
4514791683,0,14,14,0,3,7,4,1,0,1,0,15797,6.8,18289,226,64,-1234,26,22.6,1579.7,37,2,1,7,3,8,1,1,0,0,17031,7,18263,222,55,1234,-26,22.2,1703.1
4527354492,1,15,7,0,5,6,3,0,0,0,0,15678,6.8,17696,211,51,-596,774,21.1,1567.8,19,3,1,6,5,9,0,0,0,0,16274,6.8,16922,223,32,596,-774,22.3,1627.4
4516653257,1,17,3,1,6,8,7,1,1,0,0,16006,6.8,17612,233,47,-1493,-1266,23.3,1600.6,16,4,0,8,6,11,0,0,0,0,17499,7,18878,247,36,1493,1266,24.7,1749.9
4519922949,1,16,1,0,5,7,3,1,1,0,0,16590,7,18656,251,48,-283,84,25.1,1659,142,1,1,7,5,8,0,0,0,0,16873,7.2,18572,208,52,283,-84,20.8,1687.3
4511396736,0,19,1,0,4,6,5,1,0,1,0,14939,6.6,15632,189,51,-798,-1418,18.9,1493.9,11,3,1,6,4,13,1,1,0,0,15737,6.8,17050,210,50,798,1418,21,1573.7
4526046259,0,65,2,0,5,6,6,1,1,0,0,16787,7,18246,248,47,-240,-694,24.8,1678.7,17,24,1,6,5,8,1,0,1,0,17027,7.2,18940,216,63,240,694,21.6,1702.7
4506349624,1,24,4,0,6,6,4,0,0,0,0,17388,7.2,19549,250,60,1994,230,25,1738.8,37,3,1,6,6,2,1,1,0,0,15394,7.2,19319,205,63,-1994,-230,20.5,1539.4
4512793610,0,21,5,1,2,3,1,0,0,0,0,14868,7,17736,257,39,-539,-852,25.7,1486.8,15,7,0,3,2,4,1,0,1,0,15407,7.2,18588,243,58,539,852,24.3,1540.7
4506000995,0,19,4,0,3,6,3,0,0,0,0,15676,6.8,17248,267,35,-703,-1216,26.7,1567.6,46,4,1,6,3,8,1,1,0,0,16379,6.8,18464,224,56,703,1216,22.4,1637.9
4514715647,0,57,3,0,2,6,1,0,0,0,0,14230,6.6,17035,232,39,-2647,-1872,23.2,1423,16,1,1,6,2,6,2,1,1,0,16877,7,18907,254,69,2647,1872,25.4,1687.7
4509066141,1,16,4,0,5,3,10,0,0,0,1,16981,6.8,17309,214,38,384,-465,21.4,1698.1,21,1,1,3,5,2,2,1,1,1,16597,7,17774,224,64,-384,465,22.4,1659.7
4526636452,0,30,4,1,9,7,13,0,0,0,0,16374,6.6,15811,152,65,1057,-143,15.2,1637.4,16,3,0,7,9,6,1,1,0,0,15317,6.6,15954,196,44,-1057,143,19.6,1531.7
4521755848,0,39,7,1,7,6,6,0,0,0,0,17227,7,18842,218,55,1687,2040,21.8,1722.7,17,4,0,6,7,7,1,1,0,0,15540,6.8,16802,205,32,-1687,-2040,20.5,1554
4524250123,1,21,2,1,7,2,4,0,0,0,0,16631,7.2,19270,234,53,2088,1774,23.4,1663.1,28,0,0,2,7,3,1,1,0,0,14543,6.8,17496,209,64,-2088,-1774,20.9,1454.3
4513970313,0,14,2,0,5,5,4,0,0,0,0,15888,6.8,18144,218,52,-149,645,21.8,1588.8,14,0,1,5,5,4,1,1,0,0,16037,6.6,17499,204,55,149,-645,20.4,1603.7
4521710145,0,14,1,0,3,6,4,0,0,0,0,15688,6.8,17439,239,52,-1434,-1422,23.9,1568.8,11,4,1,6,3,5,1,0,1,0,17122,7,18861,237,52,1434,1422,23.7,1712.2
4526932906,0,21,3,1,5,9,6,0,0,0,0,16462,7,17215,223,52,-922,-1305,22.3,1646.2,12,2,0,9,5,11,2,1,1,0,17384,7.2,18520,227,49,922,1305,22.7,1738.4
4512196421,0,14,1,0,3,7,3,2,1,1,0,14548,6.6,17158,204,49,-2408,-2325,20.4,1454.8,13,0,1,7,3,5,0,0,0,0,16956,7.2,19483,253,52,2408,2325,25.3,1695.6
4501326958,1,22,1,0,11,5,8,1,1,0,0,18128,7.2,18825,205,41,1851,2008,20.5,1812.8,13,0,1,5,11,9,0,0,0,0,16277,6.8,16817,211,50,-1851,-2008,21.1,1627.7
4526067873,1,18,1,0,4,9,3,0,0,0,0,15162,6.8,17438,220,44,-3051,-2198,22,1516.2,48,2,1,9,4,8,2,1,1,0,18213,7.4,19636,250,53,3051,2198,25,1821.3
4515588467,1,17,2,1,2,6,2,0,0,0,0,14767,6.6,16585,230,35,-1233,-1450,23,1476.7,38,3,0,6,2,7,1,1,0,0,16000,6.8,18035,193,38,1233,1450,19.3,1600
4522190753,0,15,3,1,11,2,11,1,1,0,0,17384,7,18198,202,35,3390,2090,20.2,1738.4,36,0,0,2,11,4,0,0,0,0,13994,6.6,16108,201,48,-3390,-2090,20.1,1399.4
4524909030,0,52,0,0,6,4,7,1,0,1,0,16159,6.6,16943,208,44,1656,1298,20.8,1615.9,17,1,1,4,6,4,0,0,0,0,14503,6.4,15645,200,36,-1656,-1298,20,1450.3
4524787194,0,43,0,0,1,4,0,0,0,0,0,13046,6.2,15452,197,41,-2264,-964,19.7,1304.6,15,6,1,4,1,2,0,0,0,0,15310,6.6,16416,222,44,2264,964,22.2,1531
4509570260,0,19,4,0,1,6,1,0,0,0,0,15459,7,18187,243,71,-2483,-1894,24.3,1545.9,18,5,1,6,1,7,2,1,1,0,17942,7.4,20081,254,72,2483,1894,25.4,1794.2
4511130155,0,25,0,0,4,7,3,0,0,0,0,13886,6,14445,178,42,-4582,-3594,17.8,1388.6,14,5,1,7,4,6,2,1,1,1,18468,6.8,18039,210,51,4582,3594,21,1846.8
4526133153,0,13,14,0,6,9,4,1,0,1,0,15928,6.8,17865,206,45,-1938,-1993,20.6,1592.8,41,0,1,9,6,8,1,1,0,0,17866,7.2,19858,244,45,1938,1993,24.4,1786.6
4500727933,0,17,2,1,2,2,1,1,0,1,0,14687,6.8,17701,234,53,-668,-300,23.4,1468.7,32,5,0,2,2,2,0,0,0,0,15355,6.8,18001,255,48,668,300,25.5,1535.5
4508109073,1,17,1,1,5,6,4,1,0,1,0,17146,7,19051,240,67,954,1154,24,1714.6,23,4,0,6,5,8,1,1,0,0,16192,7,17897,212,50,-954,-1154,21.2,1619.2
4499724520,1,14,1,1,13,3,15,1,1,0,0,19814,7.6,20713,224,58,5468,5522,22.4,1981.4,10,0,0,3,13,3,0,0,0,0,14346,6.2,15191,197,32,-5468,-5522,19.7,1434.6
4526414474,0,32,2,0,10,8,8,0,0,0,0,17945,7.4,19818,206,56,209,1647,20.6,1794.5,80,3,1,8,10,3,1,1,0,1,17736,6.8,18171,196,56,-209,-1647,19.6,1773.6
4510706282,0,17,2,0,6,2,7,1,0,1,0,16646,7.2,18530,226,51,2352,1002,22.6,1664.6,12,1,1,2,6,2,1,1,0,0,14294,6.8,17528,210,60,-2352,-1002,21,1429.4
4526037415,0,15,2,1,9,7,12,0,0,0,0,17604,6.8,17925,194,49,1538,1118,19.4,1760.4,50,2,0,7,9,7,1,1,0,0,16066,6.8,16807,168,48,-1538,-1118,16.8,1606.6
4516037651,0,47,1,0,7,5,5,0,0,0,0,16089,6.8,17265,198,45,-490,-217,19.8,1608.9,17,0,1,5,7,4,1,1,0,0,16579,6.8,17482,229,57,490,217,22.9,1657.9
4521841751,0,16,0,0,6,14,9,1,1,0,0,15544,6.2,15313,176,43,-4625,-3447,17.6,1554.4,14,5,1,14,6,17,1,0,1,1,20169,7.2,18760,239,40,4625,3447,23.9,2016.9
4511221654,0,15,2,0,9,16,11,0,0,0,0,17434,7,17974,188,43,-3478,-2027,18.8,1743.4,16,3,1,16,9,21,1,1,0,0,20912,7.4,20001,196,52,3478,2027,19.6,2091.2
4516373262,0,14,2,1,4,3,5,0,0,0,0,15945,7.2,18619,204,51,405,487,20.4,1594.5,15,1,0,3,4,2,0,0,0,0,15540,7,18132,236,55,-405,-487,23.6,1554
4522526213,0,13,3,0,3,7,2,0,0,0,0,15692,7,17807,234,55,-560,476,23.4,1569.2,12,4,1,7,3,4,1,1,0,0,16252,6.8,17331,199,56,560,-476,19.9,1625.2
4526610114,1,12,1,1,9,6,8,1,1,0,0,17469,7.2,18286,206,48,2278,2188,20.6,1746.9,40,3,0,6,9,11,0,0,0,0,15191,6.4,16098,174,28,-2278,-2188,17.4,1519.1
4510548126,0,16,3,1,4,11,4,0,0,0,0,16314,6.8,16894,250,48,-2665,-900,25,1631.4,17,5,0,11,4,14,2,1,1,1,18979,7,17794,200,58,2665,900,20,1897.9
4500036039,1,18,2,1,6,3,10,0,0,0,0,16299,7,17994,234,45,1049,-291,23.4,1629.9,35,3,0,3,6,1,0,0,0,0,15250,7,18285,240,51,-1049,291,24,1525
4525370217,0,54,8,0,5,7,10,1,1,0,0,15844,6.6,16971,209,51,-2270,-2033,20.9,1584.4,29,3,1,7,5,9,0,0,0,0,18114,7.2,19004,243,64,2270,2033,24.3,1811.4
4519408439,0,89,1,0,5,7,5,0,0,0,0,15856,7,18029,224,44,295,630,22.4,1585.6,15,2,1,7,5,6,0,0,0,0,15561,6.8,17399,173,51,-295,-630,17.3,1556.1
4502491381,0,12,4,1,6,9,5,0,0,0,0,15967,6.6,17065,217,47,-2162,-2253,21.7,1596.7,41,5,0,9,6,9,0,0,0,0,18129,7.2,19318,224,53,2162,2253,22.4,1812.9
4526160950,0,51,2,1,4,2,6,0,0,0,0,15236,6.8,17761,196,52,194,143,19.6,1523.6,15,2,0,2,4,3,1,1,0,0,15042,6.8,17618,254,48,-194,-143,25.4,1504.2
4517946996,0,23,2,0,1,9,2,0,0,0,0,12941,6.4,15085,178,43,-5519,-5521,17.8,1294.1,16,6,1,9,1,10,2,1,1,0,18460,7.6,20606,253,52,5519,5521,25.3,1846
4518551820,1,18,1,0,10,8,17,1,1,0,0,17513,6.6,16367,174,48,332,-200,17.4,1751.3,24,4,1,8,10,13,0,0,0,0,17181,6.4,16567,209,46,-332,200,20.9,1718.1
4515935955,1,19,4,0,7,4,3,2,1,1,0,16700,7,19019,218,72,1039,1629,21.8,1670,14,3,1,4,7,3,0,0,0,0,15661,7,17390,248,48,-1039,-1629,24.8,1566.1
4495136621,0,16,2,1,7,5,15,0,0,0,0,18038,7,17959,241,43,3107,2223,24.1,1803.8,13,4,0,5,7,6,1,1,0,0,14931,6.4,15736,154,60,-3107,-2223,15.4,1493.1
4524261959,1,16,3,0,5,10,5,0,0,0,0,15491,6.4,15893,194,45,-2183,-2010,19.4,1549.1,20,3,1,10,5,6,0,0,0,0,17674,6.8,17903,224,35,2183,2010,22.4,1767.4
4527413531,0,16,3,0,7,13,9,0,0,0,0,16090,6.6,16407,182,44,-4191,-2861,18.2,1609,18,5,1,13,7,26,1,1,0,0,20281,7.4,19268,219,46,4191,2861,21.9,2028.1
4527682051,1,15,3,0,8,7,6,1,1,0,0,17204,7,18534,236,42,1072,1587,23.6,1720.4,14,2,1,7,8,7,0,0,0,0,16132,6.6,16947,222,38,-1072,-1587,22.2,1613.2
4507962788,1,19,2,1,3,6,2,2,1,1,0,15032,6.8,18187,207,65,-1920,-363,20.7,1503.2,15,3,0,6,3,8,0,0,0,0,16952,7,18550,246,53,1920,363,24.6,1695.2
4522051549,0,16,3,1,8,11,8,0,0,0,0,17739,6.6,16482,215,55,377,-597,21.5,1773.9,22,4,0,11,8,12,2,1,1,0,17362,6.8,17079,197,44,-377,597,19.7,1736.2
4506079101,0,16,3,1,8,9,11,1,1,0,0,16894,6.6,17233,203,50,-1529,82,20.3,1689.4,23,1,0,9,8,11,1,0,1,1,18423,6.8,17151,232,37,1529,-82,23.2,1842.3
4523550797,0,12,4,0,2,6,2,0,0,0,0,14944,6.8,17906,237,45,-2150,-1318,23.7,1494.4,22,3,1,6,2,11,1,1,0,0,17094,7.2,19224,241,76,2150,1318,24.1,1709.4
4504912203,0,39,7,1,3,4,3,0,0,0,0,14623,6.4,16060,200,36,-1585,-2306,20,1462.3,37,6,0,4,3,6,1,1,0,0,16208,6.8,18366,253,52,1585,2306,25.3,1620.8
4526076411,0,18,3,0,5,9,2,0,0,0,0,15278,6.8,17274,219,44,-3315,-1641,21.9,1527.8,15,6,1,9,5,7,1,0,1,0,18593,7.2,18915,227,56,3315,1641,22.7,1859.3
4512589969,0,16,4,1,5,2,6,0,0,0,0,17126,7,19205,249,53,2361,1802,24.9,1712.6,11,7,0,2,5,2,2,1,1,0,14765,6.8,17403,230,52,-2361,-1802,23,1476.5
4517910135,0,40,3,0,4,10,4,1,1,0,0,15494,6.8,17574,211,44,-2846,-2039,21.1,1549.4,13,5,1,10,4,12,0,0,0,0,18340,7.4,19613,213,44,2846,2039,21.3,1834
4527623126,1,16,4,1,6,6,3,1,0,1,0,16904,7.2,18744,245,54,406,782,24.5,1690.4,18,3,0,6,6,9,1,1,0,0,16498,6.8,17962,210,58,-406,-782,21,1649.8
4508392711,1,15,1,0,6,4,8,0,0,0,0,17214,7.2,18948,244,52,2045,1938,24.4,1721.4,15,3,1,4,6,5,1,1,0,0,15169,6.8,17010,220,40,-2045,-1938,22,1516.9
4526552295,1,38,1,1,6,4,8,0,0,0,0,16352,7,18600,230,52,209,-6,23,1635.2,19,5,0,4,6,6,1,0,1,0,16143,7,18606,243,48,-209,6,24.3,1614.3
4502030084,0,20,1,0,4,7,4,0,0,0,0,14696,6.6,16517,202,41,-2688,-1172,20.2,1469.6,53,4,1,7,4,5,1,1,0,0,17384,7,17689,212,56,2688,1172,21.2,1738.4
4518281398,1,22,2,1,4,5,3,0,0,0,0,15392,7,17929,222,52,-982,-1613,22.2,1539.2,15,2,0,5,4,3,1,1,0,0,16374,7.4,19542,234,64,982,1613,23.4,1637.4
4524150838,1,18,5,1,3,1,3,1,1,0,0,15928,7.4,19109,266,53,1468,1205,26.6,1592.8,37,3,0,1,3,2,0,0,0,0,14460,6.8,17904,228,68,-1468,-1205,22.8,1446
4512184861,1,18,4,1,9,4,6,0,0,0,0,18417,7.2,19926,231,64,3910,3400,23.1,1841.7,17,3,0,4,9,3,2,1,1,0,14507,6.6,16526,206,51,-3910,-3400,20.6,1450.7
4520561506,1,17,2,0,2,5,1,0,0,0,0,14981,7,18767,222,76,-1607,-48,22.2,1498.1,18,3,1,5,2,6,1,1,0,0,16588,7.2,18815,259,48,1607,48,25.9,1658.8
4519919253,1,16,0,0,5,7,4,1,0,1,0,15994,6.8,17724,225,52,-144,1497,22.5,1599.4,14,5,1,7,5,12,0,0,0,0,16138,6.4,16227,183,44,144,-1497,18.3,1613.8
4527477768,1,12,2,0,11,8,13,0,0,0,0,18420,7,19041,218,42,1472,1838,21.8,1842,18,2,1,8,11,9,0,0,0,0,16948,6.8,17203,209,41,-1472,-1838,20.9,1694.8
4522681859,0,20,3,0,7,6,6,0,0,0,0,17421,7.2,19606,241,59,1053,1304,24.1,1742.1,14,5,1,6,7,4,2,1,1,0,16368,7.2,18302,223,60,-1053,-1304,22.3,1636.8
4507071282,0,14,19,0,2,11,2,0,0,0,0,13671,6.8,16878,202,47,-5751,-4242,20.2,1367.1,62,4,1,11,2,12,1,1,0,0,19422,7.6,21120,259,48,5751,4242,25.9,1942.2
4500920231,1,17,5,0,6,5,9,1,0,1,0,17544,7,18604,230,73,1092,1401,23,1754.4,22,4,1,5,6,9,0,0,0,0,16452,6.8,17203,258,30,-1092,-1401,25.8,1645.2
4526576560,0,18,5,0,4,8,6,1,1,0,0,15589,7,18306,219,64,-2268,-1810,21.9,1558.9,31,6,1,8,4,8,0,0,0,0,17857,7.4,20116,261,58,2268,1810,26.1,1785.7
4508183655,1,12,6,0,6,1,10,0,0,0,0,16702,7.2,18943,234,56,1868,1041,23.4,1670.2,20,2,1,1,6,1,1,1,0,0,14834,7,17902,230,60,-1868,-1041,23,1483.4
4527222548,1,21,3,0,10,3,12,2,1,1,0,18211,7.4,20198,209,61,3608,3085,20.9,1821.1,62,0,1,3,10,3,0,0,0,0,14603,6.8,17113,183,52,-3608,-3085,18.3,1460.3
4521462133,0,57,2,0,4,9,3,0,0,0,0,14640,6.6,17333,224,36,-3116,-1994,22.4,1464,16,0,1,9,4,14,1,1,0,0,17756,7.2,19327,215,55,3116,1994,21.5,1775.6
4527579335,1,39,6,1,6,7,4,1,1,0,0,16211,7.2,18576,207,47,-706,-306,20.7,1621.1,18,6,0,7,6,5,0,0,0,0,16917,7,18882,239,55,706,306,23.9,1691.7
4512892156,0,18,4,1,6,5,7,0,0,0,0,16517,6.4,17161,219,49,1402,-566,21.9,1651.7,15,3,0,5,6,3,1,1,0,0,15115,7,17727,206,56,-1402,566,20.6,1511.5
4527589890,1,40,3,1,2,3,2,2,1,1,0,15723,7.2,19631,246,72,139,260,24.6,1572.3,16,2,0,3,2,2,0,0,0,0,15584,7.4,19371,253,61,-139,-260,25.3,1558.4
4505924248,0,15,3,0,2,5,3,0,0,0,0,14993,6.6,17018,241,44,-1481,-1877,24.1,1499.3,17,3,1,5,2,5,1,1,0,0,16474,7.2,18895,226,61,1481,1877,22.6,1647.4
4524216210,1,15,3,0,12,5,12,1,1,0,0,19576,7.2,18210,236,50,4417,2933,23.6,1957.6,14,2,1,5,12,9,0,0,0,0,15159,6.2,15277,198,33,-4417,-2933,19.8,1515.9
4519632042,1,49,2,0,5,4,6,0,0,0,0,15217,7,18056,195,49,-784,754,19.5,1521.7,16,9,1,4,5,5,1,1,0,0,16001,6.6,17302,238,54,784,-754,23.8,1600.1
4525567739,1,15,1,0,4,3,5,0,0,0,0,15502,7,17716,223,56,243,-31,22.3,1550.2,17,2,1,3,4,5,1,1,0,0,15259,6.8,17747,214,49,-243,31,21.4,1525.9
4505464624,0,22,3,0,4,7,2,1,1,0,0,15125,6.8,17495,200,55,-2302,-702,20,1512.5,16,0,1,7,4,9,0,0,0,0,17427,6.8,18197,207,48,2302,702,20.7,1742.7
4521893389,1,16,2,0,6,9,3,0,0,0,0,15845,6.6,16561,195,40,-1018,-981,19.5,1584.5,15,0,1,9,6,7,0,0,0,0,16863,7.2,17542,213,52,1018,981,21.3,1686.3
4509771893,1,14,1,0,6,6,8,0,0,0,0,16433,7,18215,229,52,-350,49,22.9,1643.3,16,2,1,6,6,4,0,0,0,0,16783,7,18166,224,43,350,-49,22.4,1678.3
4517546735,1,85,6,1,9,1,11,1,1,0,0,18824,7.2,19996,237,59,5240,2335,23.7,1882.4,20,2,0,1,9,0,0,0,0,0,13584,7,17661,217,42,-5240,-2335,21.7,1358.4
4519910436,1,80,1,1,6,4,4,1,1,0,0,16360,6.8,17624,234,49,1447,-149,23.4,1636,23,2,0,4,6,2,0,0,0,0,14913,7,17773,214,48,-1447,149,21.4,1491.3
4524693952,0,53,2,0,6,8,8,1,1,0,0,15128,6.2,15881,172,37,-1187,-1137,17.2,1512.8,20,2,1,8,6,9,0,0,0,0,16315,6.8,17018,179,40,1187,1137,17.9,1631.5
4522502603,1,15,7,1,11,7,6,1,0,1,0,18317,7.2,19636,229,59,2214,1305,22.9,1831.7,20,2,0,7,11,8,0,0,0,0,16103,7,18331,204,48,-2214,-1305,20.4,1610.3
4509716236,0,13,0,0,6,6,4,1,1,0,0,16248,7,18567,220,47,174,1511,22,1624.8,16,2,1,6,6,7,0,0,0,0,16074,6.6,17056,211,42,-174,-1511,21.1,1607.4
4506111258,0,43,1,1,4,7,3,0,0,0,0,15871,6.8,17457,234,31,-967,-1216,23.4,1587.1,14,6,0,7,4,8,1,1,0,0,16838,7.2,18673,214,32,967,1216,21.4,1683.8
4507328701,1,16,2,1,9,4,10,1,1,0,0,17779,7.2,19282,220,52,2178,1829,22,1777.9,11,2,0,4,9,2,0,0,0,0,15601,6.8,17453,244,56,-2178,-1829,24.4,1560.1
4527441922,0,78,4,0,8,5,9,0,0,0,0,16785,6.8,17837,186,48,-860,214,18.6,1678.5,16,3,1,5,8,7,1,1,0,0,17645,6.6,17623,236,56,860,-214,23.6,1764.5
4510543830,1,15,0,1,5,6,3,2,1,1,0,15524,6.8,17366,182,63,-700,83,18.2,1552.4,13,4,0,6,5,7,0,0,0,0,16224,6.8,17283,194,39,700,-83,19.4,1622.4
4525858898,1,18,1,1,6,7,7,0,0,0,0,16592,7,18393,221,44,813,1232,22.1,1659.2,19,4,0,7,6,8,0,0,0,0,15779,7,17161,195,47,-813,-1232,19.5,1577.9
4516912566,1,21,0,1,7,0,9,2,1,1,1,19148,7,18457,232,50,7791,6458,23.2,1914.8,10,0,0,0,7,0,0,0,0,0,11357,5.6,11999,137,45,-7791,-6458,13.7,1135.7
4525369607,0,16,2,0,8,5,7,0,0,0,0,17337,7,18952,228,56,2429,2405,22.8,1733.7,44,3,1,5,8,5,1,1,0,0,14908,6.6,16547,198,46,-2429,-2405,19.8,1490.8
4519205202,1,18,2,0,5,6,7,0,0,0,0,16003,6.6,17152,213,55,-954,-1007,21.3,1600.3,18,4,1,6,5,14,1,1,0,0,16957,7,18159,261,49,954,1007,26.1,1695.7
4509679309,1,43,3,1,8,3,9,1,0,1,0,17370,7.4,19627,249,58,2279,2409,24.9,1737,12,1,0,3,8,7,1,1,0,0,15091,7,17218,229,42,-2279,-2409,22.9,1509.1
4526857610,1,42,3,1,10,5,5,0,0,0,0,18036,7.4,19849,243,54,2203,1534,24.3,1803.6,14,4,0,5,10,5,1,1,0,0,15833,7,18315,193,72,-2203,-1534,19.3,1583.3
4525545427,1,36,0,1,3,5,2,1,1,0,0,14711,7,18380,209,52,-1244,-548,20.9,1471.1,11,1,0,5,3,6,1,0,1,0,15955,7.2,18928,234,51,1244,548,23.4,1595.5
4527222225,0,42,3,0,7,4,5,2,1,1,0,16468,6.8,17897,224,44,142,-58,22.4,1646.8,18,8,1,4,7,6,0,0,0,0,16326,7,17955,209,64,-142,58,20.9,1632.6
4527198639,0,16,1,1,4,9,2,0,0,0,0,15285,6.8,16734,194,49,-974,-815,19.4,1528.5,40,3,0,9,4,12,1,1,0,0,16259,6.6,17549,184,33,974,815,18.4,1625.9
4508149513,0,23,1,0,10,6,5,1,1,0,0,17151,7,18598,195,43,267,553,19.5,1715.1,15,4,1,6,10,5,0,0,0,0,16884,6.8,18045,234,32,-267,-553,23.4,1688.4
4523699051,1,34,3,1,10,7,12,0,0,0,0,17951,6.6,17346,211,45,2095,628,21.1,1795.1,15,2,0,7,10,4,0,0,0,0,15856,6.8,16718,171,47,-2095,-628,17.1,1585.6
4526189371,0,13,0,0,6,9,4,0,0,0,0,15917,6.8,17466,200,51,-3142,-2289,20,1591.7,13,2,1,9,6,8,0,0,0,0,19059,7.4,19755,243,56,3142,2289,24.3,1905.9
4526491541,0,17,5,1,8,8,11,1,1,0,0,17399,7,17937,245,44,381,865,24.5,1739.9,18,2,0,8,8,9,0,0,0,0,17018,6.4,17072,237,36,-381,-865,23.7,1701.8
4525312884,1,16,2,1,7,3,7,1,1,0,0,17639,7.2,18319,247,47,2392,1200,24.7,1763.9,14,4,0,3,7,3,0,0,0,0,15247,6.8,17119,214,48,-2392,-1200,21.4,1524.7
4522358340,0,21,3,1,11,10,6,0,0,0,0,17183,7,18197,208,44,157,1673,20.8,1718.3,17,4,0,10,11,14,1,1,0,0,17026,6.8,16524,188,41,-157,-1673,18.8,1702.6
4523665643,0,27,5,1,8,8,7,0,0,0,0,17130,6.8,17703,221,47,690,664,22.1,1713,19,7,0,8,8,14,0,0,0,0,16440,6.8,17039,208,48,-690,-664,20.8,1644
4496641163,0,17,4,0,4,6,6,0,0,0,0,15920,6.6,17106,229,51,-905,-2229,22.9,1592,58,4,1,6,4,12,2,1,1,0,16825,7,19335,224,46,905,2229,22.4,1682.5
4505511340,0,16,6,1,10,9,10,0,0,0,0,17818,6.8,17651,204,41,-1272,-1634,20.4,1781.8,45,9,0,9,10,9,0,0,0,0,19090,7.2,19285,258,36,1272,1634,25.8,1909
4498448542,0,21,2,0,3,3,3,2,1,1,0,15956,6.8,18145,215,73,656,526,21.5,1595.6,15,5,1,3,3,5,0,0,0,0,15300,6.8,17619,212,50,-656,-526,21.2,1530
4525583733,1,20,21,1,4,4,7,0,0,0,0,15582,6.4,15958,238,43,977,134,23.8,1558.2,42,2,0,4,4,7,1,1,0,0,14605,6.4,15824,204,36,-977,-134,20.4,1460.5
4497709596,0,17,2,1,5,10,5,2,1,1,0,16486,7,18609,244,56,-2249,-1547,24.4,1648.6,17,2,0,10,5,12,0,0,0,0,18735,7.4,20156,214,72,2249,1547,21.4,1873.5
4510559226,1,17,3,0,6,3,9,1,1,0,0,15692,6.8,17598,217,32,189,-99,21.7,1569.2,16,3,1,3,6,2,0,0,0,0,15503,6.6,17697,244,48,-189,99,24.4,1550.3
4517827670,0,19,1,1,4,8,5,0,0,0,0,14232,6.6,15999,197,41,-3089,-3265,19.7,1423.2,16,5,0,8,4,7,1,1,0,0,17321,7.2,19264,251,46,3089,3265,25.1,1732.1
4499897772,1,14,0,1,7,8,10,1,0,1,1,18133,7,17764,215,46,1025,-1153,21.5,1813.3,14,0,0,8,7,5,1,1,0,0,17108,6.8,18917,218,54,-1025,1153,21.8,1710.8
4524941419,1,13,0,0,22,6,29,1,0,1,1,23205,7,17846,208,23,7600,1865,20.8,2320.5,15,1,1,6,22,9,0,0,0,0,15605,6.4,15981,171,58,-7600,-1865,17.1,1560.5
4518184888,1,77,2,0,4,6,6,2,1,1,0,15564,7,18158,214,46,-1075,378,21.4,1556.4,17,1,1,6,4,11,0,0,0,0,16639,7,17780,240,44,1075,-378,24,1663.9
4525326999,1,40,3,1,3,3,3,1,1,0,0,14977,7,17698,223,44,98,161,22.3,1497.7,15,19,0,3,3,4,0,0,0,0,14879,6.8,17537,224,44,-98,-161,22.4,1487.9
4507966982,0,46,1,0,5,10,7,0,0,0,0,16263,6.8,16732,198,52,-1911,-2325,19.8,1626.3,16,13,1,10,5,7,1,1,0,0,18174,7.2,19057,220,45,1911,2325,22,1817.4
4490921913,1,15,4,0,7,2,7,1,1,0,0,18477,7.2,19323,275,45,4458,3839,27.5,1847.7,12,4,1,2,7,4,0,0,0,0,14019,6.2,15484,188,50,-4458,-3839,18.8,1401.9
4501037269,0,18,5,1,7,7,11,2,1,1,0,16484,7,17470,202,62,-375,-752,20.2,1648.4,80,6,0,7,7,5,0,0,0,0,16859,7.2,18222,219,41,375,752,21.9,1685.9
4525626053,0,12,2,1,2,2,2,1,0,1,0,15167,6.8,18214,244,43,7,-659,24.4,1516.7,38,4,0,2,2,3,0,0,0,0,15160,7.2,18873,242,56,-7,659,24.2,1516
4522327087,0,18,3,0,5,8,5,0,0,0,0,16007,7.2,18083,207,56,-1534,-167,20.7,1600.7,70,3,1,8,5,9,2,1,1,0,17541,6.8,18250,196,64,1534,167,19.6,1754.1
4525330228,1,19,4,0,8,6,8,0,0,0,0,18093,7,18394,231,48,1882,1490,23.1,1809.3,15,3,1,6,8,8,0,0,0,0,16211,6.8,16904,203,44,-1882,-1490,20.3,1621.1
4525010648,1,37,1,0,10,8,10,0,0,0,0,18588,7.2,19735,225,64,2382,2614,22.5,1858.8,16,1,1,8,10,7,0,0,0,0,16206,6.8,17121,192,28,-2382,-2614,19.2,1620.6
4526851533,1,66,2,1,8,1,8,1,1,0,0,16853,7,18255,226,44,2751,1464,22.6,1685.3,12,2,0,1,8,0,0,0,0,0,14102,6.8,16791,199,57,-2751,-1464,19.9,1410.2
4509949605,1,17,3,0,7,7,9,0,0,0,0,16323,7.2,18362,213,44,-451,336,21.3,1632.3,63,5,1,7,7,10,1,1,0,0,16774,6.8,18026,219,44,451,-336,21.9,1677.4
4520356694,1,15,4,0,4,6,2,0,0,0,0,15063,6.8,17979,206,64,-1213,-1013,20.6,1506.3,19,5,1,6,4,2,1,1,0,0,16276,7,18992,253,56,1213,1013,25.3,1627.6
4526101033,0,19,2,1,4,7,10,0,0,0,0,14929,6.2,15842,223,34,-3291,-2502,22.3,1492.9,19,3,0,7,4,8,2,1,1,1,18220,7.2,18344,248,56,3291,2502,24.8,1822
4519740782,1,18,1,1,6,3,5,2,1,1,0,17119,7.2,18962,233,57,2031,1967,23.3,1711.9,16,1,0,3,6,3,0,0,0,0,15088,6.8,16995,209,52,-2031,-1967,20.9,1508.8
4514345833,0,14,3,0,9,7,10,2,1,1,1,19049,7,17924,202,56,1618,-74,20.2,1904.9,14,3,1,7,9,8,0,0,0,0,17431,6.8,17998,209,42,-1618,74,20.9,1743.1
4525540282,0,17,4,1,14,5,26,1,1,0,0,19452,7,18579,209,45,3682,1284,20.9,1945.2,16,2,0,5,14,6,0,0,0,0,15770,6.6,17295,207,56,-3682,-1284,20.7,1577
4519250441,0,16,3,0,1,12,0,1,0,1,0,13981,6.6,16277,220,52,-5870,-3642,22,1398.1,41,4,1,12,1,18,0,0,0,0,19851,7.4,19919,234,53,5870,3642,23.4,1985.1
4516052882,0,12,4,1,7,11,7,0,0,0,0,15418,6.4,15315,203,31,-3531,-3889,20.3,1541.8,18,4,0,11,7,15,2,1,1,0,18949,7.4,19204,215,48,3531,3889,21.5,1894.9
4527534005,1,16,2,0,8,5,9,1,1,0,0,17636,7.2,19458,218,52,2360,2396,21.8,1763.6,48,3,1,5,8,4,0,0,0,0,15276,6.6,17062,188,48,-2360,-2396,18.8,1527.6
4525937822,1,12,7,0,6,7,8,1,1,0,0,17026,7.2,18215,229,48,326,85,22.9,1702.6,18,0,1,7,6,6,0,0,0,0,16700,6.8,18130,217,52,-326,-85,21.7,1670
4524056834,0,17,2,0,8,3,10,1,1,0,0,17084,7.2,18781,219,52,2148,1700,21.9,1708.4,15,4,1,3,8,2,0,0,0,0,14936,6.4,17081,217,52,-2148,-1700,21.7,1493.6
4518437302,0,14,2,0,3,7,3,0,0,0,0,14501,6.6,16545,195,64,-2930,-2779,19.5,1450.1,17,5,1,7,3,5,1,1,0,0,17431,7.2,19324,239,60,2930,2779,23.9,1743.1
4520825684,1,19,3,0,4,5,7,0,0,0,0,15745,6.8,17654,236,40,-1300,-652,23.6,1574.5,18,3,1,5,4,10,1,1,0,0,17045,7.2,18306,252,55,1300,652,25.2,1704.5
4525941863,1,38,2,1,5,7,6,1,1,0,0,16571,7,18777,220,65,88,413,22,1657.1,20,3,0,7,5,7,0,0,0,0,16483,7,18364,202,46,-88,-413,20.2,1648.3
4514740327,0,14,2,1,5,7,7,0,0,0,0,17224,6.8,18105,229,60,631,-265,22.9,1722.4,84,2,0,7,5,6,1,1,0,0,16593,7.2,18370,218,46,-631,265,21.8,1659.3
4522552557,1,26,3,1,9,1,14,0,0,0,0,18518,7.4,19380,224,55,4619,2904,22.4,1851.8,51,3,0,1,9,2,1,1,0,0,13899,6.6,16476,205,62,-4619,-2904,20.5,1389.9
4518532291,0,86,2,0,5,11,5,0,0,0,0,17155,7.2,18632,224,72,-1516,391,22.4,1715.5,17,2,1,11,5,12,1,1,0,0,18671,7,18241,228,40,1516,-391,22.8,1867.1
4501240960,1,16,2,0,5,5,6,1,1,0,0,16046,6.8,17207,234,41,699,18,23.4,1604.6,14,0,1,5,5,6,0,0,0,0,15347,6.6,17189,199,52,-699,-18,19.9,1534.7
4527043235,0,15,1,1,6,3,6,0,0,0,0,16986,7,18376,226,35,2587,1971,22.6,1698.6,13,2,0,3,6,4,1,1,0,0,14399,6.6,16405,208,40,-2587,-1971,20.8,1439.9
4525941193,1,40,3,1,4,6,5,1,0,1,0,16368,7,18857,216,56,-180,-890,21.6,1636.8,13,4,0,6,4,5,1,1,0,0,16548,7.4,19747,224,56,180,890,22.4,1654.8
4508992127,0,16,5,1,4,10,4,0,0,0,0,15302,6.8,16647,210,55,-3051,-2123,21,1530.2,24,4,0,10,4,12,1,1,0,0,18353,7,18770,215,50,3051,2123,21.5,1835.3
4526331089,0,14,3,0,5,6,3,1,1,0,0,15367,7.2,18799,217,56,-2021,-768,21.7,1536.7,16,4,1,6,5,7,0,0,0,0,17388,7.4,19567,238,68,2021,768,23.8,1738.8
4517588876,0,20,2,0,2,3,4,1,1,0,0,15178,6.8,17707,236,50,-673,-1332,23.6,1517.8,16,4,1,3,2,5,1,0,1,0,15851,7.2,19039,252,64,673,1332,25.2,1585.1
4523127328,0,13,4,0,4,7,3,0,0,0,0,13824,6.2,14814,167,40,-5059,-5247,16.7,1382.4,14,4,1,7,4,9,2,1,1,1,18883,7.6,20061,235,79,5059,5247,23.5,1888.3
4509906383,0,16,1,0,7,11,8,0,0,0,0,15919,6.8,16956,200,32,-2604,-1096,20,1591.9,15,1,1,11,7,10,0,0,0,0,18523,7,18052,183,48,2604,1096,18.3,1852.3
4525953760,0,30,5,0,5,11,2,1,0,1,0,16627,7,18559,229,64,-844,737,22.9,1662.7,61,6,1,11,5,14,0,0,0,0,17471,7,17822,206,40,844,-737,20.6,1747.1
4499972378,0,39,4,0,1,5,2,1,1,0,0,14032,6.4,16940,220,53,-1935,-1534,22,1403.2,15,3,1,5,1,5,0,0,0,0,15967,7.2,18474,231,45,1935,1534,23.1,1596.7
4501521847,1,90,3,1,13,5,17,1,1,0,0,18787,7,17878,193,40,3886,1777,19.3,1878.7,14,3,0,5,13,5,0,0,0,0,14901,6.6,16101,175,43,-3886,-1777,17.5,1490.1
4522436299,0,15,8,1,2,5,3,0,0,0,0,15205,6.6,16968,248,44,-977,-1320,24.8,1520.5,23,3,0,5,2,8,0,0,0,0,16182,7,18288,186,64,977,1320,18.6,1618.2
4521892508,0,16,4,1,4,8,4,1,1,0,0,15651,6.8,16945,201,48,-1990,-3002,20.1,1565.1,39,1,0,8,4,6,0,0,0,0,17641,7.4,19947,226,56,1990,3002,22.6,1764.1
4515694077,0,17,6,1,7,2,6,0,0,0,0,17376,7,18907,238,43,2809,1740,23.8,1737.6,22,2,0,2,7,3,1,0,1,0,14567,6.6,17167,234,44,-2809,-1740,23.4,1456.7
4519903713,0,33,2,0,4,11,5,1,1,0,0,15788,6.6,17331,223,52,-3084,-3141,22.3,1578.8,11,0,1,11,4,9,0,0,0,0,18872,7.6,20472,230,64,3084,3141,23,1887.2
4525018915,0,20,5,1,4,6,4,0,0,0,0,15688,6.6,16920,226,53,-162,-553,22.6,1568.8,20,7,0,6,4,10,0,0,0,0,15850,7,17473,233,44,162,553,23.3,1585
4500088034,1,17,3,0,4,6,2,1,0,1,0,15374,6.8,17943,223,49,-780,107,22.3,1537.4,18,3,1,6,4,6,1,1,0,0,16154,7.2,17836,231,61,780,-107,23.1,1615.4
4522346713,0,15,2,0,2,5,0,1,0,1,0,13418,6.4,16047,189,52,-2958,-1733,18.9,1341.8,9,3,1,5,2,5,1,1,0,0,16376,7,17780,220,63,2958,1733,22,1637.6
4518241123,0,14,0,0,4,11,4,0,0,0,0,12178,4.6,10098,120,20,-6754,-5726,12,1217.8,15,2,1,11,4,14,0,0,0,1,18932,6.4,15824,203,36,6754,5726,20.3,1893.2
4516362177,1,17,4,1,8,10,8,0,0,0,0,15984,6.6,16282,206,34,-2111,-1573,20.6,1598.4,16,2,0,10,8,14,1,0,1,0,18095,6.8,17855,208,45,2111,1573,20.8,1809.5
4413326513,1,35,2,0,3,5,3,0,0,0,0,15908,7.4,18487,220,60,-1194,-1133,22,1590.8,17,3,1,5,3,4,1,1,0,0,17102,7.2,19620,255,56,1194,1133,25.5,1710.2
4502124778,0,13,4,1,6,11,6,0,0,0,0,15240,7,17500,162,48,-3562,-2590,16.2,1524,16,0,0,11,6,8,1,1,0,0,18802,7.4,20090,221,48,3562,2590,22.1,1880.2
4512490031,1,13,1,0,3,4,3,1,1,0,0,14943,6.8,17710,223,51,-626,61,22.3,1494.3,18,1,1,4,3,8,0,0,0,0,15569,6.8,17649,233,48,626,-61,23.3,1556.9
4512278735,1,15,4,0,4,6,7,0,0,0,0,15634,7.2,18046,235,49,-1848,-617,23.5,1563.4,24,2,1,6,4,9,1,1,0,0,17482,7.2,18663,256,54,1848,617,25.6,1748.2
4527842983,1,38,2,0,6,7,10,1,1,0,0,17071,7.2,19207,245,58,374,1465,24.5,1707.1,13,6,1,7,6,10,0,0,0,0,16697,6.8,17742,209,36,-374,-1465,20.9,1669.7
4513377157,1,16,8,0,4,7,7,1,0,1,0,15726,7.2,17885,222,60,-1614,-418,22.2,1572.6,20,5,1,7,4,9,1,1,0,0,17340,7,18303,239,56,1614,418,23.9,1734
4527808251,0,38,2,0,3,2,4,0,0,0,0,15249,7.2,19121,240,45,-162,1520,24,1524.9,17,4,1,2,3,3,2,1,1,0,15411,6.8,17601,248,40,162,-1520,24.8,1541.1
4527767522,1,18,4,0,6,2,8,1,1,0,0,16055,7,18838,208,64,583,439,20.8,1605.5,38,5,1,2,6,1,0,0,0,0,15472,7.2,18399,259,54,-583,-439,25.9,1547.2
4527853173,0,17,0,0,2,8,1,0,0,0,0,13446,6.4,15500,190,32,-4676,-3551,19,1344.6,10,6,1,8,2,9,2,1,1,0,18122,7.2,19051,243,50,4676,3551,24.3,1812.2
4527742166,0,20,5,1,4,4,5,1,1,0,0,15903,7,17640,239,48,428,400,23.9,1590.3,17,3,0,4,4,6,0,0,0,0,15475,6.8,17240,217,57,-428,-400,21.7,1547.5
4527648336,0,38,6,1,9,5,7,0,0,0,0,16940,7.2,18098,203,36,893,256,20.3,1694,19,16,0,5,9,5,1,1,0,0,16047,7,17842,228,48,-893,-256,22.8,1604.7
4527888798,1,12,3,0,8,4,7,1,0,1,0,16882,7.2,18657,221,35,1632,1767,22.1,1688.2,12,2,1,4,8,4,0,0,0,0,15250,6.6,16890,179,44,-1632,-1767,17.9,1525
4525312579,0,80,5,0,6,7,3,0,0,0,0,15894,7,17808,212,52,-1019,-1564,21.2,1589.4,23,7,1,7,6,4,1,1,0,0,16913,7.2,19372,229,44,1019,1564,22.9,1691.3
4527909697,1,40,4,0,4,1,13,2,1,1,0,16047,7,18644,244,48,1976,1778,24.4,1604.7,13,6,1,1,4,1,0,0,0,0,14071,6.8,16866,222,44,-1976,-1778,22.2,1407.1
4527637091,0,15,2,0,4,8,2,0,0,0,0,14709,6.6,17092,217,38,-2591,-1250,21.7,1470.9,13,3,1,8,4,10,1,1,0,0,17300,7.2,18342,236,55,2591,1250,23.6,1730
4527658315,1,38,6,0,6,6,9,1,0,1,0,16368,7,17821,234,47,-1314,-1708,23.4,1636.8,17,6,1,6,6,4,1,1,0,0,17682,7.2,19529,230,76,1314,1708,23,1768.2
4527865649,0,17,2,0,7,8,9,1,0,1,0,17394,6.8,17904,261,32,188,-676,26.1,1739.4,29,4,1,8,7,7,0,0,0,0,17206,7,18580,212,56,-188,676,21.2,1720.6
4527796790,1,11,2,0,6,6,7,1,1,0,0,15950,6.8,17303,196,55,175,-234,19.6,1595,84,2,1,6,6,4,0,0,0,0,15775,6.8,17537,221,28,-175,234,22.1,1577.5
4527433973,0,15,3,0,2,7,3,0,0,0,0,15268,6.8,17717,214,72,-880,179,21.4,1526.8,18,0,1,7,2,8,0,0,0,0,16148,6.6,17538,198,42,880,-179,19.8,1614.8
4527887542,1,19,1,1,10,2,12,0,0,0,0,18274,6.8,19011,232,49,4693,2968,23.2,1827.4,16,1,0,2,10,1,0,0,0,0,13581,6.4,16043,179,45,-4693,-2968,17.9,1358.1
4527750562,0,37,4,1,5,7,6,0,0,0,0,15993,6.8,17528,206,48,-645,-448,20.6,1599.3,19,5,0,7,5,9,1,1,0,0,16638,6.8,17976,197,64,645,448,19.7,1663.8
4527782537,0,51,3,1,3,6,7,1,1,0,0,14857,6.8,16510,226,43,-959,-1248,22.6,1485.7,29,3,0,6,3,3,1,0,1,0,15816,6.8,17758,195,58,959,1248,19.5,1581.6
4527696871,1,36,2,1,9,4,11,1,1,0,0,18503,7.4,19717,250,56,2527,1695,25,1850.3,26,16,0,4,9,9,0,0,0,0,15976,7,18022,210,63,-2527,-1695,21,1597.6
4527990640,1,85,3,0,8,7,11,1,0,1,0,17442,7.2,20005,210,68,-347,966,21,1744.2,13,1,1,7,8,10,0,0,0,0,17789,7.2,19039,218,58,347,-966,21.8,1778.9
4527729232,0,36,3,0,4,13,5,0,0,0,0,14478,6.2,14665,171,32,-5087,-4618,17.1,1447.8,40,3,1,13,4,12,0,0,0,0,19565,7.2,19283,199,71,5087,4618,19.9,1956.5
4521542969,1,13,3,1,6,4,10,2,1,1,0,17086,7,17746,229,54,1838,-689,22.9,1708.6,14,3,0,4,6,7,0,0,0,0,15248,7.2,18435,231,51,-1838,689,23.1,1524.8
4527658739,1,16,3,0,5,7,6,1,0,1,2,18075,7.2,19324,233,60,600,289,23.3,1807.5,37,4,1,7,5,6,1,1,0,0,17475,7,19035,224,63,-600,-289,22.4,1747.5
4527898486,1,57,3,1,5,4,5,1,1,0,0,15965,7,18534,208,52,725,1773,20.8,1596.5,16,3,0,4,5,5,1,0,1,0,15240,6.8,16761,202,40,-725,-1773,20.2,1524
4527885240,1,34,1,0,4,7,1,0,0,0,0,15261,7,18671,223,60,-1461,-69,22.3,1526.1,15,0,1,7,4,8,1,1,0,0,16722,7,18740,215,56,1461,69,21.5,1672.2
4527780032,1,16,3,0,1,2,0,1,1,0,0,14603,7,18478,232,71,670,1446,23.2,1460.3,38,3,1,2,1,5,0,0,0,0,13933,6.8,17032,197,52,-670,-1446,19.7,1393.3
4527908858,0,14,2,0,1,3,0,1,0,1,0,13836,6.6,17114,213,59,-1798,-674,21.3,1383.6,14,3,1,3,1,4,1,1,0,0,15634,6.8,17788,251,46,1798,674,25.1,1563.4
4527960459,1,16,4,1,7,1,5,1,0,1,0,17170,7,19211,251,54,3234,2427,25.1,1717,21,2,0,1,7,1,0,0,0,0,13936,6.8,16784,203,68,-3234,-2427,20.3,1393.6
4527875317,0,12,1,0,9,12,12,1,1,0,0,16198,7,18249,165,33,-2121,-1038,16.5,1619.8,13,3,1,12,9,7,1,0,1,0,18319,7.4,19287,187,68,2121,1038,18.7,1831.9
4527811425,1,46,2,1,5,3,2,0,0,0,0,16923,7.2,19758,222,72,1974,1712,22.2,1692.3,11,0,0,3,5,5,1,1,0,0,14949,6.8,18046,202,64,-1974,-1712,20.2,1494.9
4527715781,0,12,2,0,4,5,5,2,1,1,0,15131,6.8,18216,214,61,-727,343,21.4,1513.1,17,4,1,5,4,2,0,0,0,0,15858,6.8,17873,248,48,727,-343,24.8,1585.8
4527650398,1,12,0,1,7,7,9,0,0,0,0,17155,7,18002,231,36,756,1,23.1,1715.5,60,3,0,7,7,8,1,1,0,0,16399,7,18001,216,58,-756,-1,21.6,1639.9
4527878058,1,18,2,1,12,6,13,0,0,0,0,18573,7.2,19391,207,46,2639,2364,20.7,1857.3,16,6,0,6,12,6,0,0,0,0,15934,6.6,17027,197,38,-2639,-2364,19.7,1593.4
4527873286,1,17,2,1,7,4,5,1,1,0,0,17765,7.2,18967,211,69,2519,2469,21.1,1776.5,46,3,0,4,7,7,0,0,0,0,15246,6.8,16498,229,34,-2519,-2469,22.9,1524.6
4527797466,1,54,0,0,6,4,8,1,1,0,0,16238,7.2,19255,233,48,782,888,23.3,1623.8,12,21,1,4,6,3,0,0,0,0,15456,7,18367,206,56,-782,-888,20.6,1545.6
4527713716,0,23,1,0,6,7,5,0,0,0,0,15903,7,18032,210,45,-2416,-1877,21,1590.3,14,0,1,7,6,11,1,1,0,0,18319,7.4,19909,261,60,2416,1877,26.1,1831.9
4527628313,0,14,4,1,2,3,3,1,1,0,0,14459,6.6,17229,224,48,-839,-1085,22.4,1445.9,66,4,0,3,2,1,0,0,0,0,15298,7.2,18314,247,40,839,1085,24.7,1529.8
4523772935,1,18,0,1,6,6,5,0,0,0,0,16266,7,17321,207,44,927,-58,20.7,1626.6,9,2,0,6,6,4,1,1,0,0,15339,6.8,17379,201,46,-927,58,20.1,1533.9
